id,sub_total,shipping_cost,shipping_total,grand_total,split_test_variant_id,"created_at","updated_at"
1,8900,1531,1531,10431,2,"2016-08-30 21:25:48","2016-08-30 21:25:48"
2,8000,1420,0,8000,2,"2016-08-30 21:25:48","2016-08-30 21:25:48"
3,7000,1478,1478,8478,1,"2016-08-30 21:25:48","2016-08-30 21:25:48"
4,8500,1572,1572,10072,1,"2016-08-30 21:25:48","2016-08-30 21:25:48"
5,8900,1565,0,8900,2,"2016-08-30 21:25:48","2016-08-30 21:25:48"
6,6000,1410,1410,7410,1,"2016-08-30 21:25:48","2016-08-30 21:25:48"
7,8900,1558,0,8900,2,"2016-08-30 21:25:48","2016-08-30 21:25:48"
8,4000,1398,1398,5398,2,"2016-08-30 21:25:48","2016-08-30 21:25:48"
9,5000,1371,1371,6371,1,"2016-08-30 21:25:48","2016-08-30 21:25:48"
10,9900,1654,1654,11554,1,"2016-08-30 21:25:48","2016-08-30 21:25:48"
11,4000,1311,1311,5311,1,"2016-08-30 21:25:48","2016-08-30 21:25:48"
12,8900,1632,1632,10532,2,"2016-08-30 21:25:48","2016-08-30 21:25:48"
13,4000,1287,1287,5287,1,"2016-08-30 21:25:48","2016-08-30 21:25:48"
14,5000,1340,1340,6340,1,"2016-08-30 21:25:48","2016-08-30 21:25:48"
15,4000,1308,1308,5308,1,"2016-08-30 21:25:48","2016-08-30 21:25:48"
16,5000,1400,1400,6400,2,"2016-08-30 21:25:48","2016-08-30 21:25:48"
17,8000,1502,0,8000,2,"2016-08-30 21:25:48","2016-08-30 21:25:48"
18,8500,1523,0,8500,2,"2016-08-30 21:25:48","2016-08-30 21:25:48"
19,8000,1584,0,8000,2,"2016-08-30 21:25:48","2016-08-30 21:25:48"
20,5000,1433,1433,6433,2,"2016-08-30 21:25:48","2016-08-30 21:25:48"
21,8500,1591,0,8500,2,"2016-08-30 21:25:48","2016-08-30 21:25:48"
22,9900,1587,1587,11487,2,"2016-08-30 21:25:48","2016-08-30 21:25:48"
23,8000,1531,1531,9531,2,"2016-08-30 21:25:48","2016-08-30 21:25:48"
24,8500,1492,0,8500,2,"2016-08-30 21:25:48","2016-08-30 21:25:48"
25,8000,1420,0,8000,2,"2016-08-30 21:25:48","2016-08-30 21:25:48"
26,4000,1302,1302,5302,1,"2016-08-30 21:25:48","2016-08-30 21:25:48"
27,8500,1563,0,8500,2,"2016-08-30 21:25:48","2016-08-30 21:25:48"
28,8900,1597,0,8900,2,"2016-08-30 21:25:48","2016-08-30 21:25:48"
29,8500,1536,0,8500,2,"2016-08-30 21:25:48","2016-08-30 21:25:48"
30,9500,1595,0,9500,2,"2016-08-30 21:25:48","2016-08-30 21:25:48"
31,8000,1527,1527,9527,1,"2016-08-30 21:25:48","2016-08-30 21:25:48"
32,5000,1328,1328,6328,1,"2016-08-30 21:25:48","2016-08-30 21:25:48"
33,4000,1287,1287,5287,1,"2016-08-30 21:25:48","2016-08-30 21:25:48"
34,8500,1585,1585,10085,1,"2016-08-30 21:25:48","2016-08-30 21:25:48"
35,8000,1504,0,8000,2,"2016-08-30 21:25:48","2016-08-30 21:25:48"
36,8500,1479,0,8500,2,"2016-08-30 21:25:48","2016-08-30 21:25:48"
37,9900,1636,1636,11536,1,"2016-08-30 21:25:48","2016-08-30 21:25:48"
38,8000,1458,0,8000,2,"2016-08-30 21:25:48","2016-08-30 21:25:48"
39,9900,1520,1520,11420,2,"2016-08-30 21:25:48","2016-08-30 21:25:48"
40,8000,1475,0,8000,2,"2016-08-30 21:25:48","2016-08-30 21:25:48"
41,4000,1364,1364,5364,1,"2016-08-30 21:25:48","2016-08-30 21:25:48"
42,9500,1523,1523,11023,1,"2016-08-30 21:25:48","2016-08-30 21:25:48"
43,9900,1536,1536,11436,1,"2016-08-30 21:25:48","2016-08-30 21:25:48"
44,8000,1466,0,8000,2,"2016-08-30 21:25:48","2016-08-30 21:25:48"
45,8000,1476,0,8000,2,"2016-08-30 21:25:48","2016-08-30 21:25:48"
46,8000,1510,0,8000,2,"2016-08-30 21:25:48","2016-08-30 21:25:48"
47,8000,1556,1556,9556,1,"2016-08-30 21:25:48","2016-08-30 21:25:48"
48,8500,1505,1505,10005,1,"2016-08-30 21:25:48","2016-08-30 21:25:48"
49,6000,1470,1470,7470,1,"2016-08-30 21:25:48","2016-08-30 21:25:48"
50,9900,1554,1554,11454,1,"2016-08-30 21:25:48","2016-08-30 21:25:48"
51,7000,1542,1542,8542,1,"2016-08-30 21:25:48","2016-08-30 21:25:48"
52,8900,1530,0,8900,2,"2016-08-30 21:25:48","2016-08-30 21:25:48"
53,8000,1577,1577,9577,1,"2016-08-30 21:25:48","2016-08-30 21:25:48"
54,9000,1634,1634,10634,1,"2016-08-30 21:25:48","2016-08-30 21:25:48"
55,8500,1624,0,8500,2,"2016-08-30 21:25:48","2016-08-30 21:25:48"
56,9900,1509,1509,11409,1,"2016-08-30 21:25:48","2016-08-30 21:25:48"
57,8500,1500,0,8500,2,"2016-08-30 21:25:48","2016-08-30 21:25:48"
58,9900,1590,1590,11490,1,"2016-08-30 21:25:48","2016-08-30 21:25:48"
59,8000,1547,0,8000,2,"2016-08-30 21:25:48","2016-08-30 21:25:48"
60,8500,1455,0,8500,2,"2016-08-30 21:25:48","2016-08-30 21:25:48"
61,8000,1568,0,8000,2,"2016-08-30 21:25:48","2016-08-30 21:25:48"
62,8000,1471,0,8000,2,"2016-08-30 21:25:48","2016-08-30 21:25:48"
63,9900,1532,1532,11432,1,"2016-08-30 21:25:48","2016-08-30 21:25:48"
64,8900,1608,1608,10508,1,"2016-08-30 21:25:48","2016-08-30 21:25:48"
65,8900,1643,1643,10543,1,"2016-08-30 21:25:48","2016-08-30 21:25:48"
66,5000,1381,1381,6381,1,"2016-08-30 21:25:48","2016-08-30 21:25:48"
67,8900,1541,1541,10441,1,"2016-08-30 21:25:48","2016-08-30 21:25:48"
68,9900,1619,1619,11519,1,"2016-08-30 21:25:48","2016-08-30 21:25:48"
69,8000,1523,1523,9523,1,"2016-08-30 21:25:48","2016-08-30 21:25:48"
70,9000,1545,1545,10545,1,"2016-08-30 21:25:48","2016-08-30 21:25:48"
71,8000,1476,1476,9476,1,"2016-08-30 21:25:48","2016-08-30 21:25:48"
72,8900,1544,1544,10444,1,"2016-08-30 21:25:48","2016-08-30 21:25:48"
73,8900,1486,0,8900,2,"2016-08-30 21:25:48","2016-08-30 21:25:48"
74,8000,1509,0,8000,2,"2016-08-30 21:25:48","2016-08-30 21:25:48"
75,8900,1579,0,8900,2,"2016-08-30 21:25:48","2016-08-30 21:25:48"
76,8500,1601,0,8500,2,"2016-08-30 21:25:48","2016-08-30 21:25:48"
77,8000,1523,0,8000,2,"2016-08-30 21:25:48","2016-08-30 21:25:48"
78,9900,1641,1641,11541,1,"2016-08-30 21:25:48","2016-08-30 21:25:48"
79,8000,1491,0,8000,2,"2016-08-30 21:25:48","2016-08-30 21:25:48"
80,8000,1452,0,8000,2,"2016-08-30 21:25:48","2016-08-30 21:25:48"
81,8000,1588,1588,9588,2,"2016-08-30 21:25:48","2016-08-30 21:25:48"
82,8000,1543,0,8000,2,"2016-08-30 21:25:48","2016-08-30 21:25:48"
83,8000,1521,0,8000,2,"2016-08-30 21:25:48","2016-08-30 21:25:48"
84,8000,1556,1556,9556,2,"2016-08-30 21:25:48","2016-08-30 21:25:48"
85,8500,1503,1503,10003,1,"2016-08-30 21:25:48","2016-08-30 21:25:48"
86,9000,1634,0,9000,2,"2016-08-30 21:25:48","2016-08-30 21:25:48"
87,7000,1367,1367,8367,1,"2016-08-30 21:25:48","2016-08-30 21:25:48"
88,8500,1477,0,8500,2,"2016-08-30 21:25:48","2016-08-30 21:25:48"
89,8500,1604,1604,10104,1,"2016-08-30 21:25:48","2016-08-30 21:25:48"
90,5000,1355,1355,6355,1,"2016-08-30 21:25:48","2016-08-30 21:25:48"
91,8000,1410,0,8000,2,"2016-08-30 21:25:48","2016-08-30 21:25:48"
92,8000,1587,0,8000,2,"2016-08-30 21:25:48","2016-08-30 21:25:48"
93,8000,1533,0,8000,2,"2016-08-30 21:25:48","2016-08-30 21:25:48"
94,6000,1421,1421,7421,1,"2016-08-30 21:25:48","2016-08-30 21:25:48"
95,8000,1564,1564,9564,1,"2016-08-30 21:25:48","2016-08-30 21:25:48"
96,4000,1287,1287,5287,1,"2016-08-30 21:25:48","2016-08-30 21:25:48"
97,8000,1511,1511,9511,1,"2016-08-30 21:25:48","2016-08-30 21:25:48"
98,9000,1570,1570,10570,1,"2016-08-30 21:25:48","2016-08-30 21:25:48"
99,8900,1599,1599,10499,1,"2016-08-30 21:25:48","2016-08-30 21:25:48"
100,9500,1527,1527,11027,1,"2016-08-30 21:25:48","2016-08-30 21:25:48"
101,8500,1490,0,8500,2,"2016-08-30 21:25:48","2016-08-30 21:25:48"
102,8900,1564,0,8900,2,"2016-08-30 21:25:48","2016-08-30 21:25:48"
103,8500,1612,0,8500,2,"2016-08-30 21:25:48","2016-08-30 21:25:48"
104,4000,1290,1290,5290,1,"2016-08-30 21:25:48","2016-08-30 21:25:48"
105,8500,1495,1495,9995,2,"2016-08-30 21:25:48","2016-08-30 21:25:48"
106,9000,1599,1599,10599,1,"2016-08-30 21:25:48","2016-08-30 21:25:48"
107,8900,1467,0,8900,2,"2016-08-30 21:25:48","2016-08-30 21:25:48"
108,8000,1594,0,8000,2,"2016-08-30 21:25:48","2016-08-30 21:25:48"
109,4000,1218,1218,5218,1,"2016-08-30 21:25:48","2016-08-30 21:25:48"
110,8000,1500,1500,9500,1,"2016-08-30 21:25:48","2016-08-30 21:25:48"
111,6000,1305,1305,7305,1,"2016-08-30 21:25:48","2016-08-30 21:25:48"
112,5000,1396,1396,6396,1,"2016-08-30 21:25:48","2016-08-30 21:25:48"
113,4000,1349,1349,5349,2,"2016-08-30 21:25:48","2016-08-30 21:25:48"
114,8000,1577,0,8000,2,"2016-08-30 21:25:48","2016-08-30 21:25:48"
115,5000,1395,1395,6395,2,"2016-08-30 21:25:48","2016-08-30 21:25:48"
116,8500,1603,0,8500,2,"2016-08-30 21:25:48","2016-08-30 21:25:48"
117,9500,1521,1521,11021,1,"2016-08-30 21:25:48","2016-08-30 21:25:48"
118,5000,1354,1354,6354,1,"2016-08-30 21:25:48","2016-08-30 21:25:48"
119,8500,1534,1534,10034,1,"2016-08-30 21:25:48","2016-08-30 21:25:48"
120,9900,1683,0,9900,2,"2016-08-30 21:25:48","2016-08-30 21:25:48"
121,8000,1467,0,8000,2,"2016-08-30 21:25:48","2016-08-30 21:25:48"
122,4000,1342,1342,5342,1,"2016-08-30 21:25:48","2016-08-30 21:25:48"
123,5000,1426,1426,6426,1,"2016-08-30 21:25:48","2016-08-30 21:25:48"
124,9900,1668,1668,11568,1,"2016-08-30 21:25:48","2016-08-30 21:25:48"
125,8500,1555,1555,10055,1,"2016-08-30 21:25:48","2016-08-30 21:25:48"
126,8900,1446,0,8900,2,"2016-08-30 21:25:48","2016-08-30 21:25:48"
127,6000,1429,1429,7429,1,"2016-08-30 21:25:48","2016-08-30 21:25:48"
128,8900,1639,1639,10539,1,"2016-08-30 21:25:48","2016-08-30 21:25:48"
129,9900,1562,0,9900,2,"2016-08-30 21:25:48","2016-08-30 21:25:48"
130,8000,1494,0,8000,2,"2016-08-30 21:25:48","2016-08-30 21:25:48"
131,9900,1624,1624,11524,1,"2016-08-30 21:25:48","2016-08-30 21:25:48"
132,8000,1558,1558,9558,2,"2016-08-30 21:25:48","2016-08-30 21:25:48"
133,8000,1540,1540,9540,1,"2016-08-30 21:25:48","2016-08-30 21:25:48"
134,4000,1356,1356,5356,2,"2016-08-30 21:25:48","2016-08-30 21:25:48"
135,8900,1562,1562,10462,1,"2016-08-30 21:25:48","2016-08-30 21:25:48"
136,9900,1499,0,9900,2,"2016-08-30 21:25:48","2016-08-30 21:25:48"
137,5000,1374,1374,6374,1,"2016-08-30 21:25:48","2016-08-30 21:25:48"
138,4000,1302,1302,5302,1,"2016-08-30 21:25:48","2016-08-30 21:25:48"
139,8000,1411,0,8000,2,"2016-08-30 21:25:48","2016-08-30 21:25:48"
140,5000,1419,1419,6419,1,"2016-08-30 21:25:48","2016-08-30 21:25:48"
141,9000,1502,1502,10502,2,"2016-08-30 21:25:48","2016-08-30 21:25:48"
142,8000,1516,0,8000,2,"2016-08-30 21:25:48","2016-08-30 21:25:48"
143,8000,1553,0,8000,2,"2016-08-30 21:25:48","2016-08-30 21:25:48"
144,8000,1536,0,8000,2,"2016-08-30 21:25:48","2016-08-30 21:25:48"
145,7000,1486,1486,8486,2,"2016-08-30 21:25:48","2016-08-30 21:25:48"
146,9500,1639,1639,11139,1,"2016-08-30 21:25:48","2016-08-30 21:25:48"
147,8900,1503,1503,10403,2,"2016-08-30 21:25:48","2016-08-30 21:25:48"
148,4000,1375,1375,5375,2,"2016-08-30 21:25:48","2016-08-30 21:25:48"
149,8000,1479,0,8000,2,"2016-08-30 21:25:48","2016-08-30 21:25:48"
150,8500,1624,1624,10124,1,"2016-08-30 21:25:48","2016-08-30 21:25:48"
151,8000,1410,0,8000,2,"2016-08-30 21:25:48","2016-08-30 21:25:48"
152,6000,1313,1313,7313,1,"2016-08-30 21:25:48","2016-08-30 21:25:48"
153,8500,1598,1598,10098,1,"2016-08-30 21:25:48","2016-08-30 21:25:48"
154,8500,1616,0,8500,2,"2016-08-30 21:25:48","2016-08-30 21:25:48"
155,8900,1467,0,8900,2,"2016-08-30 21:25:48","2016-08-30 21:25:48"
156,6000,1367,1367,7367,1,"2016-08-30 21:25:48","2016-08-30 21:25:48"
157,8000,1456,0,8000,2,"2016-08-30 21:25:48","2016-08-30 21:25:48"
158,8500,1441,0,8500,2,"2016-08-30 21:25:48","2016-08-30 21:25:48"
159,5000,1273,1273,6273,1,"2016-08-30 21:25:48","2016-08-30 21:25:48"
160,9900,1664,1664,11564,1,"2016-08-30 21:25:48","2016-08-30 21:25:48"
161,5000,1352,1352,6352,1,"2016-08-30 21:25:48","2016-08-30 21:25:48"
162,8500,1440,0,8500,2,"2016-08-30 21:25:48","2016-08-30 21:25:48"
163,8000,1456,0,8000,2,"2016-08-30 21:25:48","2016-08-30 21:25:48"
164,8000,1442,1442,9442,1,"2016-08-30 21:25:48","2016-08-30 21:25:48"
165,8000,1506,1506,9506,1,"2016-08-30 21:25:48","2016-08-30 21:25:48"
166,4000,1362,1362,5362,1,"2016-08-30 21:25:48","2016-08-30 21:25:48"
167,9000,1461,1461,10461,1,"2016-08-30 21:25:48","2016-08-30 21:25:48"
168,8000,1418,0,8000,2,"2016-08-30 21:25:48","2016-08-30 21:25:48"
169,8000,1498,0,8000,2,"2016-08-30 21:25:48","2016-08-30 21:25:48"
170,9500,1554,1554,11054,1,"2016-08-30 21:25:48","2016-08-30 21:25:48"
171,8000,1421,1421,9421,1,"2016-08-30 21:25:48","2016-08-30 21:25:48"
172,6000,1378,1378,7378,1,"2016-08-30 21:25:48","2016-08-30 21:25:48"
173,4000,1350,1350,5350,1,"2016-08-30 21:25:48","2016-08-30 21:25:48"
174,4000,1222,1222,5222,2,"2016-08-30 21:25:48","2016-08-30 21:25:48"
175,8000,1471,0,8000,2,"2016-08-30 21:25:48","2016-08-30 21:25:48"
176,8900,1540,0,8900,2,"2016-08-30 21:25:48","2016-08-30 21:25:48"
177,8500,1617,0,8500,2,"2016-08-30 21:25:48","2016-08-30 21:25:48"
178,8000,1494,1494,9494,1,"2016-08-30 21:25:48","2016-08-30 21:25:48"
179,4000,1340,1340,5340,1,"2016-08-30 21:25:48","2016-08-30 21:25:48"
180,9900,1528,1528,11428,1,"2016-08-30 21:25:48","2016-08-30 21:25:48"
181,4000,1319,1319,5319,1,"2016-08-30 21:25:48","2016-08-30 21:25:48"
182,5000,1442,1442,6442,1,"2016-08-30 21:25:48","2016-08-30 21:25:48"
183,8900,1600,0,8900,2,"2016-08-30 21:25:48","2016-08-30 21:25:48"
184,8500,1466,0,8500,2,"2016-08-30 21:25:48","2016-08-30 21:25:48"
185,8900,1518,0,8900,2,"2016-08-30 21:25:48","2016-08-30 21:25:48"
186,8500,1437,0,8500,2,"2016-08-30 21:25:48","2016-08-30 21:25:48"
187,4000,1363,1363,5363,1,"2016-08-30 21:25:49","2016-08-30 21:25:49"
188,8500,1504,0,8500,2,"2016-08-30 21:25:49","2016-08-30 21:25:49"
189,9500,1502,0,9500,2,"2016-08-30 21:25:49","2016-08-30 21:25:49"
190,8000,1473,0,8000,2,"2016-08-30 21:25:49","2016-08-30 21:25:49"
191,9900,1579,1579,11479,1,"2016-08-30 21:25:49","2016-08-30 21:25:49"
192,9900,1546,0,9900,2,"2016-08-30 21:25:49","2016-08-30 21:25:49"
193,5000,1305,1305,6305,1,"2016-08-30 21:25:49","2016-08-30 21:25:49"
194,8000,1466,0,8000,2,"2016-08-30 21:25:49","2016-08-30 21:25:49"
195,8000,1528,1528,9528,1,"2016-08-30 21:25:49","2016-08-30 21:25:49"
196,8500,1535,0,8500,2,"2016-08-30 21:25:49","2016-08-30 21:25:49"
197,5000,1403,1403,6403,1,"2016-08-30 21:25:49","2016-08-30 21:25:49"
198,8000,1503,0,8000,2,"2016-08-30 21:25:49","2016-08-30 21:25:49"
199,9900,1561,0,9900,2,"2016-08-30 21:25:49","2016-08-30 21:25:49"
200,8000,1436,1436,9436,1,"2016-08-30 21:25:49","2016-08-30 21:25:49"
201,9000,1593,1593,10593,1,"2016-08-30 21:25:49","2016-08-30 21:25:49"
202,8000,1451,1451,9451,1,"2016-08-30 21:25:49","2016-08-30 21:25:49"
203,4000,1319,1319,5319,2,"2016-08-30 21:25:49","2016-08-30 21:25:49"
204,7000,1489,1489,8489,1,"2016-08-30 21:25:49","2016-08-30 21:25:49"
205,8900,1578,1578,10478,2,"2016-08-30 21:25:49","2016-08-30 21:25:49"
206,5000,1311,1311,6311,1,"2016-08-30 21:25:49","2016-08-30 21:25:49"
207,5000,1263,1263,6263,1,"2016-08-30 21:25:49","2016-08-30 21:25:49"
208,9500,1575,1575,11075,1,"2016-08-30 21:25:49","2016-08-30 21:25:49"
209,8500,1460,0,8500,2,"2016-08-30 21:25:49","2016-08-30 21:25:49"
210,8000,1567,0,8000,2,"2016-08-30 21:25:49","2016-08-30 21:25:49"
211,4000,1342,1342,5342,1,"2016-08-30 21:25:49","2016-08-30 21:25:49"
212,8000,1596,1596,9596,2,"2016-08-30 21:25:49","2016-08-30 21:25:49"
213,8500,1585,1585,10085,2,"2016-08-30 21:25:49","2016-08-30 21:25:49"
214,8000,1404,0,8000,2,"2016-08-30 21:25:49","2016-08-30 21:25:49"
215,5000,1394,1394,6394,2,"2016-08-30 21:25:49","2016-08-30 21:25:49"
216,9900,1648,0,9900,2,"2016-08-30 21:25:49","2016-08-30 21:25:49"
217,9000,1640,1640,10640,1,"2016-08-30 21:25:49","2016-08-30 21:25:49"
218,9900,1687,0,9900,2,"2016-08-30 21:25:49","2016-08-30 21:25:49"
219,5000,1270,1270,6270,2,"2016-08-30 21:25:49","2016-08-30 21:25:49"
220,4000,1208,1208,5208,2,"2016-08-30 21:25:49","2016-08-30 21:25:49"
221,8000,1461,1461,9461,2,"2016-08-30 21:25:49","2016-08-30 21:25:49"
222,8000,1544,0,8000,2,"2016-08-30 21:25:49","2016-08-30 21:25:49"
223,7000,1458,1458,8458,1,"2016-08-30 21:25:49","2016-08-30 21:25:49"
224,8000,1522,1522,9522,1,"2016-08-30 21:25:49","2016-08-30 21:25:49"
225,8000,1464,0,8000,2,"2016-08-30 21:25:49","2016-08-30 21:25:49"
226,9500,1506,0,9500,2,"2016-08-30 21:25:49","2016-08-30 21:25:49"
227,8900,1492,0,8900,2,"2016-08-30 21:25:49","2016-08-30 21:25:49"
228,9000,1622,1622,10622,1,"2016-08-30 21:25:49","2016-08-30 21:25:49"
229,8900,1492,1492,10392,1,"2016-08-30 21:25:49","2016-08-30 21:25:49"
230,8000,1498,1498,9498,1,"2016-08-30 21:25:49","2016-08-30 21:25:49"
231,9900,1642,1642,11542,1,"2016-08-30 21:25:49","2016-08-30 21:25:49"
232,8500,1575,0,8500,2,"2016-08-30 21:25:49","2016-08-30 21:25:49"
233,4000,1379,1379,5379,1,"2016-08-30 21:25:49","2016-08-30 21:25:49"
234,9900,1537,1537,11437,1,"2016-08-30 21:25:49","2016-08-30 21:25:49"
235,8000,1558,0,8000,2,"2016-08-30 21:25:49","2016-08-30 21:25:49"
236,9900,1602,1602,11502,1,"2016-08-30 21:25:49","2016-08-30 21:25:49"
237,8900,1621,0,8900,2,"2016-08-30 21:25:49","2016-08-30 21:25:49"
238,5000,1365,1365,6365,1,"2016-08-30 21:25:49","2016-08-30 21:25:49"
239,8500,1546,1546,10046,1,"2016-08-30 21:25:49","2016-08-30 21:25:49"
240,8900,1493,1493,10393,1,"2016-08-30 21:25:49","2016-08-30 21:25:49"
241,8900,1481,1481,10381,2,"2016-08-30 21:25:49","2016-08-30 21:25:49"
242,9900,1552,1552,11452,1,"2016-08-30 21:25:49","2016-08-30 21:25:49"
243,5000,1277,1277,6277,2,"2016-08-30 21:25:49","2016-08-30 21:25:49"
244,7000,1495,1495,8495,1,"2016-08-30 21:25:49","2016-08-30 21:25:49"
245,8900,1473,0,8900,2,"2016-08-30 21:25:49","2016-08-30 21:25:49"
246,4000,1210,1210,5210,2,"2016-08-30 21:25:49","2016-08-30 21:25:49"
247,4000,1365,1365,5365,1,"2016-08-30 21:25:49","2016-08-30 21:25:49"
248,4000,1394,1394,5394,1,"2016-08-30 21:25:49","2016-08-30 21:25:49"
249,8500,1442,1442,9942,1,"2016-08-30 21:25:49","2016-08-30 21:25:49"
250,4000,1216,1216,5216,1,"2016-08-30 21:25:49","2016-08-30 21:25:49"
251,4000,1323,1323,5323,1,"2016-08-30 21:25:49","2016-08-30 21:25:49"
252,7000,1466,1466,8466,2,"2016-08-30 21:25:49","2016-08-30 21:25:49"
253,4000,1243,1243,5243,1,"2016-08-30 21:25:49","2016-08-30 21:25:49"
254,8000,1562,0,8000,2,"2016-08-30 21:25:49","2016-08-30 21:25:49"
255,4000,1379,1379,5379,1,"2016-08-30 21:25:49","2016-08-30 21:25:49"
256,8900,1526,1526,10426,1,"2016-08-30 21:25:49","2016-08-30 21:25:49"
257,9900,1604,1604,11504,1,"2016-08-30 21:25:49","2016-08-30 21:25:49"
258,4000,1241,1241,5241,1,"2016-08-30 21:25:49","2016-08-30 21:25:49"
259,5000,1262,1262,6262,2,"2016-08-30 21:25:49","2016-08-30 21:25:49"
260,8000,1475,1475,9475,2,"2016-08-30 21:25:49","2016-08-30 21:25:49"
261,7000,1413,1413,8413,1,"2016-08-30 21:25:49","2016-08-30 21:25:49"
262,7000,1488,1488,8488,1,"2016-08-30 21:25:49","2016-08-30 21:25:49"
263,4000,1250,1250,5250,1,"2016-08-30 21:25:49","2016-08-30 21:25:49"
264,7000,1465,1465,8465,2,"2016-08-30 21:25:49","2016-08-30 21:25:49"
265,8000,1543,0,8000,2,"2016-08-30 21:25:49","2016-08-30 21:25:49"
266,8000,1493,1493,9493,1,"2016-08-30 21:25:49","2016-08-30 21:25:49"
267,8500,1521,1521,10021,1,"2016-08-30 21:25:49","2016-08-30 21:25:49"
268,8500,1583,0,8500,2,"2016-08-30 21:25:49","2016-08-30 21:25:49"
269,9900,1554,0,9900,2,"2016-08-30 21:25:49","2016-08-30 21:25:49"
270,9900,1566,1566,11466,1,"2016-08-30 21:25:49","2016-08-30 21:25:49"
271,8000,1465,0,8000,2,"2016-08-30 21:25:49","2016-08-30 21:25:49"
272,8000,1413,1413,9413,1,"2016-08-30 21:25:49","2016-08-30 21:25:49"
273,7000,1415,1415,8415,2,"2016-08-30 21:25:49","2016-08-30 21:25:49"
274,8500,1445,0,8500,2,"2016-08-30 21:25:49","2016-08-30 21:25:49"
275,9900,1534,1534,11434,2,"2016-08-30 21:25:49","2016-08-30 21:25:49"
276,8000,1495,0,8000,2,"2016-08-30 21:25:49","2016-08-30 21:25:49"
277,8000,1467,0,8000,2,"2016-08-30 21:25:49","2016-08-30 21:25:49"
278,8000,1401,1401,9401,1,"2016-08-30 21:25:49","2016-08-30 21:25:49"
279,9000,1472,1472,10472,1,"2016-08-30 21:25:49","2016-08-30 21:25:49"
280,6000,1487,1487,7487,2,"2016-08-30 21:25:49","2016-08-30 21:25:49"
281,8500,1472,0,8500,2,"2016-08-30 21:25:49","2016-08-30 21:25:49"
282,8500,1494,1494,9994,2,"2016-08-30 21:25:49","2016-08-30 21:25:49"
283,5000,1358,1358,6358,1,"2016-08-30 21:25:49","2016-08-30 21:25:49"
284,8900,1621,0,8900,2,"2016-08-30 21:25:49","2016-08-30 21:25:49"
285,8900,1562,1562,10462,1,"2016-08-30 21:25:49","2016-08-30 21:25:49"
286,8500,1470,1470,9970,1,"2016-08-30 21:25:49","2016-08-30 21:25:49"
287,8900,1565,1565,10465,1,"2016-08-30 21:25:49","2016-08-30 21:25:49"
288,8000,1482,1482,9482,2,"2016-08-30 21:25:49","2016-08-30 21:25:49"
289,7000,1495,1495,8495,1,"2016-08-30 21:25:49","2016-08-30 21:25:49"
290,5000,1408,1408,6408,1,"2016-08-30 21:25:49","2016-08-30 21:25:49"
291,6000,1395,1395,7395,1,"2016-08-30 21:25:49","2016-08-30 21:25:49"
292,8000,1507,0,8000,2,"2016-08-30 21:25:49","2016-08-30 21:25:49"
293,8000,1522,1522,9522,2,"2016-08-30 21:25:49","2016-08-30 21:25:49"
294,9500,1617,1617,11117,1,"2016-08-30 21:25:49","2016-08-30 21:25:49"
295,9500,1590,1590,11090,1,"2016-08-30 21:25:49","2016-08-30 21:25:49"
296,9900,1529,1529,11429,1,"2016-08-30 21:25:49","2016-08-30 21:25:49"
297,9900,1658,1658,11558,1,"2016-08-30 21:25:49","2016-08-30 21:25:49"
298,8000,1401,1401,9401,2,"2016-08-30 21:25:49","2016-08-30 21:25:49"
299,8000,1486,0,8000,2,"2016-08-30 21:25:49","2016-08-30 21:25:49"
300,8900,1632,1632,10532,1,"2016-08-30 21:25:49","2016-08-30 21:25:49"
301,8000,1581,1581,9581,2,"2016-08-30 21:25:49","2016-08-30 21:25:49"
302,7000,1380,1380,8380,1,"2016-08-30 21:25:49","2016-08-30 21:25:49"
303,7000,1459,1459,8459,1,"2016-08-30 21:25:49","2016-08-30 21:25:49"
304,8000,1591,1591,9591,1,"2016-08-30 21:25:49","2016-08-30 21:25:49"
305,5000,1310,1310,6310,2,"2016-08-30 21:25:49","2016-08-30 21:25:49"
306,8900,1448,0,8900,2,"2016-08-30 21:25:49","2016-08-30 21:25:49"
307,8500,1565,0,8500,2,"2016-08-30 21:25:49","2016-08-30 21:25:49"
308,9900,1524,1524,11424,1,"2016-08-30 21:25:49","2016-08-30 21:25:49"
309,8900,1602,0,8900,2,"2016-08-30 21:25:49","2016-08-30 21:25:49"
310,8000,1520,0,8000,2,"2016-08-30 21:25:49","2016-08-30 21:25:49"
311,7000,1463,1463,8463,1,"2016-08-30 21:25:49","2016-08-30 21:25:49"
312,5000,1436,1436,6436,1,"2016-08-30 21:25:49","2016-08-30 21:25:49"
313,9500,1484,1484,10984,1,"2016-08-30 21:25:49","2016-08-30 21:25:49"
314,4000,1221,1221,5221,1,"2016-08-30 21:25:49","2016-08-30 21:25:49"
315,8900,1447,1447,10347,1,"2016-08-30 21:25:49","2016-08-30 21:25:49"
316,8500,1578,0,8500,2,"2016-08-30 21:25:49","2016-08-30 21:25:49"
317,9900,1500,1500,11400,1,"2016-08-30 21:25:49","2016-08-30 21:25:49"
318,7000,1353,1353,8353,2,"2016-08-30 21:25:49","2016-08-30 21:25:49"
319,9900,1658,1658,11558,1,"2016-08-30 21:25:49","2016-08-30 21:25:49"
320,9000,1563,1563,10563,1,"2016-08-30 21:25:49","2016-08-30 21:25:49"
321,7000,1542,1542,8542,1,"2016-08-30 21:25:49","2016-08-30 21:25:49"
322,8000,1542,0,8000,2,"2016-08-30 21:25:49","2016-08-30 21:25:49"
323,4000,1387,1387,5387,2,"2016-08-30 21:25:49","2016-08-30 21:25:49"
324,8000,1470,1470,9470,2,"2016-08-30 21:25:49","2016-08-30 21:25:49"
325,8000,1402,0,8000,2,"2016-08-30 21:25:49","2016-08-30 21:25:49"
326,8500,1598,0,8500,2,"2016-08-30 21:25:49","2016-08-30 21:25:49"
327,9900,1579,1579,11479,1,"2016-08-30 21:25:49","2016-08-30 21:25:49"
328,8900,1501,0,8900,2,"2016-08-30 21:25:49","2016-08-30 21:25:49"
329,8500,1581,0,8500,2,"2016-08-30 21:25:49","2016-08-30 21:25:49"
330,8900,1481,1481,10381,1,"2016-08-30 21:25:49","2016-08-30 21:25:49"
331,8000,1543,0,8000,2,"2016-08-30 21:25:49","2016-08-30 21:25:49"
332,7000,1478,1478,8478,1,"2016-08-30 21:25:49","2016-08-30 21:25:49"
333,9500,1519,0,9500,2,"2016-08-30 21:25:49","2016-08-30 21:25:49"
334,9900,1623,1623,11523,1,"2016-08-30 21:25:49","2016-08-30 21:25:49"
335,5000,1356,1356,6356,1,"2016-08-30 21:25:49","2016-08-30 21:25:49"
336,8500,1502,0,8500,2,"2016-08-30 21:25:49","2016-08-30 21:25:49"
337,8000,1505,0,8000,2,"2016-08-30 21:25:49","2016-08-30 21:25:49"
338,4000,1357,1357,5357,1,"2016-08-30 21:25:49","2016-08-30 21:25:49"
339,8900,1462,0,8900,2,"2016-08-30 21:25:49","2016-08-30 21:25:49"
340,8000,1576,0,8000,2,"2016-08-30 21:25:49","2016-08-30 21:25:49"
341,8000,1471,0,8000,2,"2016-08-30 21:25:49","2016-08-30 21:25:49"
342,8000,1501,0,8000,2,"2016-08-30 21:25:49","2016-08-30 21:25:49"
343,8000,1580,0,8000,2,"2016-08-30 21:25:49","2016-08-30 21:25:49"
344,9000,1541,1541,10541,1,"2016-08-30 21:25:49","2016-08-30 21:25:49"
345,9900,1549,1549,11449,1,"2016-08-30 21:25:49","2016-08-30 21:25:49"
346,8000,1458,0,8000,2,"2016-08-30 21:25:49","2016-08-30 21:25:49"
347,8500,1589,0,8500,2,"2016-08-30 21:25:49","2016-08-30 21:25:49"
348,7000,1539,1539,8539,1,"2016-08-30 21:25:49","2016-08-30 21:25:49"
349,9900,1639,1639,11539,2,"2016-08-30 21:25:49","2016-08-30 21:25:49"
350,4000,1231,1231,5231,1,"2016-08-30 21:25:49","2016-08-30 21:25:49"
351,8500,1591,1591,10091,1,"2016-08-30 21:25:49","2016-08-30 21:25:49"
352,9000,1490,1490,10490,1,"2016-08-30 21:25:49","2016-08-30 21:25:49"
353,7000,1442,1442,8442,2,"2016-08-30 21:25:49","2016-08-30 21:25:49"
354,8900,1488,0,8900,2,"2016-08-30 21:25:49","2016-08-30 21:25:49"
355,6000,1335,1335,7335,1,"2016-08-30 21:25:49","2016-08-30 21:25:49"
356,8900,1589,1589,10489,1,"2016-08-30 21:25:49","2016-08-30 21:25:49"
357,8500,1530,0,8500,2,"2016-08-30 21:25:49","2016-08-30 21:25:49"
358,4000,1259,1259,5259,2,"2016-08-30 21:25:49","2016-08-30 21:25:49"
359,8000,1593,0,8000,2,"2016-08-30 21:25:49","2016-08-30 21:25:49"
360,9000,1609,0,9000,2,"2016-08-30 21:25:49","2016-08-30 21:25:49"
361,8000,1447,1447,9447,1,"2016-08-30 21:25:49","2016-08-30 21:25:49"
362,8000,1590,0,8000,2,"2016-08-30 21:25:49","2016-08-30 21:25:49"
363,9500,1523,0,9500,2,"2016-08-30 21:25:49","2016-08-30 21:25:49"
364,8500,1515,0,8500,2,"2016-08-30 21:25:49","2016-08-30 21:25:49"
365,9900,1629,0,9900,2,"2016-08-30 21:25:49","2016-08-30 21:25:49"
366,9900,1590,1590,11490,1,"2016-08-30 21:25:49","2016-08-30 21:25:49"
367,7000,1481,1481,8481,2,"2016-08-30 21:25:49","2016-08-30 21:25:49"
368,9900,1596,1596,11496,1,"2016-08-30 21:25:49","2016-08-30 21:25:49"
369,8000,1469,0,8000,2,"2016-08-30 21:25:49","2016-08-30 21:25:49"
370,8000,1591,1591,9591,2,"2016-08-30 21:25:49","2016-08-30 21:25:49"
371,8000,1476,0,8000,2,"2016-08-30 21:25:49","2016-08-30 21:25:49"
372,9900,1635,1635,11535,1,"2016-08-30 21:25:49","2016-08-30 21:25:49"
373,8000,1585,0,8000,2,"2016-08-30 21:25:49","2016-08-30 21:25:49"
374,8500,1467,1467,9967,1,"2016-08-30 21:25:49","2016-08-30 21:25:49"
375,4000,1296,1296,5296,2,"2016-08-30 21:25:49","2016-08-30 21:25:49"
376,9000,1572,0,9000,2,"2016-08-30 21:25:49","2016-08-30 21:25:49"
377,8500,1472,0,8500,2,"2016-08-30 21:25:49","2016-08-30 21:25:49"
378,8500,1489,1489,9989,2,"2016-08-30 21:25:49","2016-08-30 21:25:49"
379,6000,1308,1308,7308,1,"2016-08-30 21:25:49","2016-08-30 21:25:49"
380,8900,1584,0,8900,2,"2016-08-30 21:25:49","2016-08-30 21:25:49"
381,8900,1466,0,8900,2,"2016-08-30 21:25:49","2016-08-30 21:25:49"
382,6000,1414,1414,7414,1,"2016-08-30 21:25:49","2016-08-30 21:25:49"
383,4000,1245,1245,5245,1,"2016-08-30 21:25:49","2016-08-30 21:25:49"
384,8000,1578,1578,9578,1,"2016-08-30 21:25:49","2016-08-30 21:25:49"
385,5000,1316,1316,6316,2,"2016-08-30 21:25:49","2016-08-30 21:25:49"
386,8000,1481,1481,9481,1,"2016-08-30 21:25:49","2016-08-30 21:25:49"
387,8000,1411,0,8000,2,"2016-08-30 21:25:49","2016-08-30 21:25:49"
388,8000,1480,0,8000,2,"2016-08-30 21:25:49","2016-08-30 21:25:49"
389,5000,1311,1311,6311,1,"2016-08-30 21:25:49","2016-08-30 21:25:49"
390,8900,1554,0,8900,2,"2016-08-30 21:25:49","2016-08-30 21:25:49"
391,8500,1578,1578,10078,2,"2016-08-30 21:25:49","2016-08-30 21:25:49"
392,9900,1581,1581,11481,1,"2016-08-30 21:25:49","2016-08-30 21:25:49"
393,8500,1526,0,8500,2,"2016-08-30 21:25:49","2016-08-30 21:25:49"
394,8500,1621,0,8500,2,"2016-08-30 21:25:49","2016-08-30 21:25:49"
395,8000,1501,0,8000,2,"2016-08-30 21:25:49","2016-08-30 21:25:49"
396,8000,1435,0,8000,2,"2016-08-30 21:25:49","2016-08-30 21:25:49"
397,9000,1466,1466,10466,1,"2016-08-30 21:25:49","2016-08-30 21:25:49"
398,9900,1540,1540,11440,1,"2016-08-30 21:25:49","2016-08-30 21:25:49"
399,9900,1635,0,9900,2,"2016-08-30 21:25:49","2016-08-30 21:25:49"
400,8000,1471,1471,9471,1,"2016-08-30 21:25:49","2016-08-30 21:25:49"
401,8000,1428,0,8000,2,"2016-08-30 21:25:49","2016-08-30 21:25:49"
402,9900,1646,1646,11546,1,"2016-08-30 21:25:49","2016-08-30 21:25:49"
403,8900,1512,0,8900,2,"2016-08-30 21:25:49","2016-08-30 21:25:49"
404,8000,1471,0,8000,2,"2016-08-30 21:25:49","2016-08-30 21:25:49"
405,8000,1414,1414,9414,1,"2016-08-30 21:25:49","2016-08-30 21:25:49"
406,8000,1547,1547,9547,1,"2016-08-30 21:25:49","2016-08-30 21:25:49"
407,8000,1447,1447,9447,2,"2016-08-30 21:25:49","2016-08-30 21:25:49"
408,8500,1437,0,8500,2,"2016-08-30 21:25:49","2016-08-30 21:25:49"
409,8900,1469,1469,10369,1,"2016-08-30 21:25:49","2016-08-30 21:25:49"
410,4000,1371,1371,5371,2,"2016-08-30 21:25:49","2016-08-30 21:25:49"
411,9900,1602,1602,11502,1,"2016-08-30 21:25:49","2016-08-30 21:25:49"
412,9500,1528,0,9500,2,"2016-08-30 21:25:49","2016-08-30 21:25:49"
413,8000,1596,0,8000,2,"2016-08-30 21:25:49","2016-08-30 21:25:49"
414,8000,1586,0,8000,2,"2016-08-30 21:25:49","2016-08-30 21:25:49"
415,8000,1558,0,8000,2,"2016-08-30 21:25:49","2016-08-30 21:25:49"
416,9900,1512,1512,11412,1,"2016-08-30 21:25:49","2016-08-30 21:25:49"
417,8500,1479,1479,9979,1,"2016-08-30 21:25:49","2016-08-30 21:25:49"
418,8000,1411,1411,9411,1,"2016-08-30 21:25:49","2016-08-30 21:25:49"
419,4000,1208,1208,5208,1,"2016-08-30 21:25:49","2016-08-30 21:25:49"
420,7000,1536,1536,8536,1,"2016-08-30 21:25:49","2016-08-30 21:25:49"
421,8000,1585,1585,9585,2,"2016-08-30 21:25:49","2016-08-30 21:25:49"
422,8000,1580,0,8000,2,"2016-08-30 21:25:49","2016-08-30 21:25:49"
423,9900,1599,0,9900,2,"2016-08-30 21:25:49","2016-08-30 21:25:49"
424,7000,1455,1455,8455,2,"2016-08-30 21:25:49","2016-08-30 21:25:49"
425,8500,1512,0,8500,2,"2016-08-30 21:25:49","2016-08-30 21:25:49"
426,8500,1620,1620,10120,1,"2016-08-30 21:25:49","2016-08-30 21:25:49"
427,6000,1427,1427,7427,1,"2016-08-30 21:25:49","2016-08-30 21:25:49"
428,8000,1551,0,8000,2,"2016-08-30 21:25:49","2016-08-30 21:25:49"
429,8500,1506,1506,10006,2,"2016-08-30 21:25:49","2016-08-30 21:25:49"
430,8900,1612,0,8900,2,"2016-08-30 21:25:49","2016-08-30 21:25:49"
431,8000,1409,1409,9409,2,"2016-08-30 21:25:49","2016-08-30 21:25:49"
432,5000,1389,1389,6389,2,"2016-08-30 21:25:49","2016-08-30 21:25:49"
433,8000,1401,1401,9401,2,"2016-08-30 21:25:49","2016-08-30 21:25:49"
434,8900,1637,0,8900,2,"2016-08-30 21:25:49","2016-08-30 21:25:49"
435,8000,1577,1577,9577,2,"2016-08-30 21:25:49","2016-08-30 21:25:49"
436,5000,1357,1357,6357,2,"2016-08-30 21:25:49","2016-08-30 21:25:49"
437,8000,1581,1581,9581,1,"2016-08-30 21:25:49","2016-08-30 21:25:49"
438,7000,1376,1376,8376,1,"2016-08-30 21:25:49","2016-08-30 21:25:49"
439,4000,1300,1300,5300,1,"2016-08-30 21:25:49","2016-08-30 21:25:49"
440,8500,1512,1512,10012,1,"2016-08-30 21:25:49","2016-08-30 21:25:49"
441,8000,1525,0,8000,2,"2016-08-30 21:25:49","2016-08-30 21:25:49"
442,8000,1542,1542,9542,1,"2016-08-30 21:25:49","2016-08-30 21:25:49"
443,8500,1501,1501,10001,1,"2016-08-30 21:25:49","2016-08-30 21:25:49"
444,8000,1550,0,8000,2,"2016-08-30 21:25:49","2016-08-30 21:25:49"
445,8000,1527,0,8000,2,"2016-08-30 21:25:49","2016-08-30 21:25:49"
446,8000,1512,1512,9512,1,"2016-08-30 21:25:49","2016-08-30 21:25:49"
447,6000,1465,1465,7465,1,"2016-08-30 21:25:49","2016-08-30 21:25:49"
448,9000,1523,1523,10523,1,"2016-08-30 21:25:49","2016-08-30 21:25:49"
449,5000,1250,1250,6250,1,"2016-08-30 21:25:49","2016-08-30 21:25:49"
450,9500,1602,1602,11102,1,"2016-08-30 21:25:49","2016-08-30 21:25:49"
451,8500,1594,0,8500,2,"2016-08-30 21:25:49","2016-08-30 21:25:49"
452,8000,1447,1447,9447,2,"2016-08-30 21:25:49","2016-08-30 21:25:49"
453,5000,1416,1416,6416,2,"2016-08-30 21:25:49","2016-08-30 21:25:49"
454,4000,1389,1389,5389,1,"2016-08-30 21:25:49","2016-08-30 21:25:49"
455,8900,1512,0,8900,2,"2016-08-30 21:25:49","2016-08-30 21:25:49"
456,4000,1380,1380,5380,1,"2016-08-30 21:25:49","2016-08-30 21:25:49"
457,9900,1553,1553,11453,1,"2016-08-30 21:25:49","2016-08-30 21:25:49"
458,4000,1250,1250,5250,1,"2016-08-30 21:25:49","2016-08-30 21:25:49"
459,6000,1475,1475,7475,2,"2016-08-30 21:25:49","2016-08-30 21:25:49"
460,9900,1632,0,9900,2,"2016-08-30 21:25:49","2016-08-30 21:25:49"
461,8000,1413,1413,9413,2,"2016-08-30 21:25:49","2016-08-30 21:25:49"
462,4000,1272,1272,5272,1,"2016-08-30 21:25:49","2016-08-30 21:25:49"
463,8900,1588,1588,10488,1,"2016-08-30 21:25:49","2016-08-30 21:25:49"
464,8500,1536,1536,10036,1,"2016-08-30 21:25:49","2016-08-30 21:25:49"
465,4000,1203,1203,5203,1,"2016-08-30 21:25:49","2016-08-30 21:25:49"
466,6000,1447,1447,7447,1,"2016-08-30 21:25:49","2016-08-30 21:25:49"
467,8500,1469,1469,9969,1,"2016-08-30 21:25:49","2016-08-30 21:25:49"
468,5000,1324,1324,6324,1,"2016-08-30 21:25:49","2016-08-30 21:25:49"
469,7000,1448,1448,8448,2,"2016-08-30 21:25:49","2016-08-30 21:25:49"
470,5000,1336,1336,6336,1,"2016-08-30 21:25:49","2016-08-30 21:25:49"
471,8500,1517,0,8500,2,"2016-08-30 21:25:49","2016-08-30 21:25:49"
472,4000,1291,1291,5291,1,"2016-08-30 21:25:49","2016-08-30 21:25:49"
473,9000,1566,1566,10566,1,"2016-08-30 21:25:49","2016-08-30 21:25:49"
474,8500,1601,0,8500,2,"2016-08-30 21:25:49","2016-08-30 21:25:49"
475,8500,1601,1601,10101,1,"2016-08-30 21:25:49","2016-08-30 21:25:49"
476,5000,1367,1367,6367,2,"2016-08-30 21:25:49","2016-08-30 21:25:49"
477,8900,1474,0,8900,2,"2016-08-30 21:25:49","2016-08-30 21:25:49"
478,4000,1315,1315,5315,2,"2016-08-30 21:25:49","2016-08-30 21:25:49"
479,8500,1442,1442,9942,1,"2016-08-30 21:25:49","2016-08-30 21:25:49"
480,9500,1632,1632,11132,1,"2016-08-30 21:25:49","2016-08-30 21:25:49"
481,6000,1419,1419,7419,1,"2016-08-30 21:25:49","2016-08-30 21:25:49"
482,8000,1566,0,8000,2,"2016-08-30 21:25:49","2016-08-30 21:25:49"
483,4000,1204,1204,5204,2,"2016-08-30 21:25:49","2016-08-30 21:25:49"
484,9900,1670,1670,11570,1,"2016-08-30 21:25:49","2016-08-30 21:25:49"
485,8500,1482,0,8500,2,"2016-08-30 21:25:49","2016-08-30 21:25:49"
486,7000,1540,1540,8540,2,"2016-08-30 21:25:49","2016-08-30 21:25:49"
487,9500,1672,1672,11172,1,"2016-08-30 21:25:49","2016-08-30 21:25:49"
488,8900,1598,0,8900,2,"2016-08-30 21:25:49","2016-08-30 21:25:49"
489,4000,1271,1271,5271,1,"2016-08-30 21:25:49","2016-08-30 21:25:49"
490,8900,1585,0,8900,2,"2016-08-30 21:25:50","2016-08-30 21:25:50"
491,8000,1479,0,8000,2,"2016-08-30 21:25:50","2016-08-30 21:25:50"
492,8500,1491,1491,9991,1,"2016-08-30 21:25:50","2016-08-30 21:25:50"
493,9000,1462,1462,10462,2,"2016-08-30 21:25:50","2016-08-30 21:25:50"
494,8000,1424,1424,9424,2,"2016-08-30 21:25:50","2016-08-30 21:25:50"
495,6000,1426,1426,7426,1,"2016-08-30 21:25:50","2016-08-30 21:25:50"
496,8500,1612,1612,10112,2,"2016-08-30 21:25:50","2016-08-30 21:25:50"
497,8500,1494,1494,9994,1,"2016-08-30 21:25:50","2016-08-30 21:25:50"
498,9900,1672,1672,11572,1,"2016-08-30 21:25:50","2016-08-30 21:25:50"
499,9500,1616,0,9500,2,"2016-08-30 21:25:50","2016-08-30 21:25:50"
500,9000,1621,1621,10621,2,"2016-08-30 21:25:50","2016-08-30 21:25:50"
501,8900,1478,0,8900,2,"2016-08-30 21:25:50","2016-08-30 21:25:50"
502,8500,1581,1581,10081,1,"2016-08-30 21:25:50","2016-08-30 21:25:50"
503,6000,1342,1342,7342,1,"2016-08-30 21:25:50","2016-08-30 21:25:50"
504,7000,1504,1504,8504,1,"2016-08-30 21:25:50","2016-08-30 21:25:50"
505,8000,1498,1498,9498,1,"2016-08-30 21:25:50","2016-08-30 21:25:50"
506,8500,1465,0,8500,2,"2016-08-30 21:25:50","2016-08-30 21:25:50"
507,8500,1471,0,8500,2,"2016-08-30 21:25:50","2016-08-30 21:25:50"
508,8000,1407,0,8000,2,"2016-08-30 21:25:50","2016-08-30 21:25:50"
509,8900,1452,0,8900,2,"2016-08-30 21:25:50","2016-08-30 21:25:50"
510,9900,1623,0,9900,2,"2016-08-30 21:25:50","2016-08-30 21:25:50"
511,8500,1531,1531,10031,2,"2016-08-30 21:25:50","2016-08-30 21:25:50"
512,4000,1375,1375,5375,1,"2016-08-30 21:25:50","2016-08-30 21:25:50"
513,8500,1621,0,8500,2,"2016-08-30 21:25:50","2016-08-30 21:25:50"
514,9500,1526,1526,11026,1,"2016-08-30 21:25:50","2016-08-30 21:25:50"
515,8000,1499,0,8000,2,"2016-08-30 21:25:50","2016-08-30 21:25:50"
516,8500,1520,0,8500,2,"2016-08-30 21:25:50","2016-08-30 21:25:50"
517,8500,1450,1450,9950,2,"2016-08-30 21:25:50","2016-08-30 21:25:50"
518,4000,1237,1237,5237,2,"2016-08-30 21:25:50","2016-08-30 21:25:50"
519,4000,1316,1316,5316,2,"2016-08-30 21:25:50","2016-08-30 21:25:50"
520,9500,1555,1555,11055,1,"2016-08-30 21:25:50","2016-08-30 21:25:50"
521,8500,1499,0,8500,2,"2016-08-30 21:25:50","2016-08-30 21:25:50"
522,8000,1453,0,8000,2,"2016-08-30 21:25:50","2016-08-30 21:25:50"
523,8500,1621,1621,10121,1,"2016-08-30 21:25:50","2016-08-30 21:25:50"
524,8500,1490,0,8500,2,"2016-08-30 21:25:50","2016-08-30 21:25:50"
525,8500,1427,0,8500,2,"2016-08-30 21:25:50","2016-08-30 21:25:50"
526,8900,1588,0,8900,2,"2016-08-30 21:25:50","2016-08-30 21:25:50"
527,8900,1493,1493,10393,1,"2016-08-30 21:25:50","2016-08-30 21:25:50"
528,9000,1575,0,9000,2,"2016-08-30 21:25:50","2016-08-30 21:25:50"
529,8900,1564,0,8900,2,"2016-08-30 21:25:50","2016-08-30 21:25:50"
530,8900,1581,0,8900,2,"2016-08-30 21:25:50","2016-08-30 21:25:50"
531,8000,1570,1570,9570,2,"2016-08-30 21:25:50","2016-08-30 21:25:50"
532,8000,1464,0,8000,2,"2016-08-30 21:25:50","2016-08-30 21:25:50"
533,4000,1209,1209,5209,2,"2016-08-30 21:25:50","2016-08-30 21:25:50"
534,8900,1610,0,8900,2,"2016-08-30 21:25:50","2016-08-30 21:25:50"
535,8000,1539,0,8000,2,"2016-08-30 21:25:50","2016-08-30 21:25:50"
536,8500,1608,1608,10108,1,"2016-08-30 21:25:50","2016-08-30 21:25:50"
537,8900,1575,1575,10475,1,"2016-08-30 21:25:50","2016-08-30 21:25:50"
538,9900,1593,1593,11493,1,"2016-08-30 21:25:50","2016-08-30 21:25:50"
539,8000,1553,0,8000,2,"2016-08-30 21:25:50","2016-08-30 21:25:50"
540,8500,1454,1454,9954,2,"2016-08-30 21:25:50","2016-08-30 21:25:50"
541,8500,1427,0,8500,2,"2016-08-30 21:25:50","2016-08-30 21:25:50"
542,4000,1292,1292,5292,1,"2016-08-30 21:25:50","2016-08-30 21:25:50"
543,4000,1217,1217,5217,1,"2016-08-30 21:25:50","2016-08-30 21:25:50"
544,8000,1418,1418,9418,1,"2016-08-30 21:25:50","2016-08-30 21:25:50"
545,6000,1335,1335,7335,2,"2016-08-30 21:25:50","2016-08-30 21:25:50"
546,9500,1616,0,9500,2,"2016-08-30 21:25:50","2016-08-30 21:25:50"
547,8000,1461,0,8000,2,"2016-08-30 21:25:50","2016-08-30 21:25:50"
548,8900,1615,0,8900,2,"2016-08-30 21:25:50","2016-08-30 21:25:50"
549,5000,1314,1314,6314,1,"2016-08-30 21:25:50","2016-08-30 21:25:50"
550,8000,1559,1559,9559,1,"2016-08-30 21:25:50","2016-08-30 21:25:50"
551,8000,1426,0,8000,2,"2016-08-30 21:25:50","2016-08-30 21:25:50"
552,6000,1398,1398,7398,1,"2016-08-30 21:25:50","2016-08-30 21:25:50"
553,8900,1522,0,8900,2,"2016-08-30 21:25:50","2016-08-30 21:25:50"
554,8000,1443,1443,9443,1,"2016-08-30 21:25:50","2016-08-30 21:25:50"
555,8500,1525,0,8500,2,"2016-08-30 21:25:50","2016-08-30 21:25:50"
556,8900,1638,0,8900,2,"2016-08-30 21:25:50","2016-08-30 21:25:50"
557,4000,1248,1248,5248,1,"2016-08-30 21:25:50","2016-08-30 21:25:50"
558,8900,1446,1446,10346,1,"2016-08-30 21:25:50","2016-08-30 21:25:50"
559,8000,1426,1426,9426,1,"2016-08-30 21:25:50","2016-08-30 21:25:50"
560,8900,1617,1617,10517,1,"2016-08-30 21:25:50","2016-08-30 21:25:50"
561,8500,1447,1447,9947,1,"2016-08-30 21:25:50","2016-08-30 21:25:50"
562,8000,1434,0,8000,2,"2016-08-30 21:25:50","2016-08-30 21:25:50"
563,4000,1207,1207,5207,1,"2016-08-30 21:25:50","2016-08-30 21:25:50"
564,8500,1516,1516,10016,1,"2016-08-30 21:25:50","2016-08-30 21:25:50"
565,8900,1474,0,8900,2,"2016-08-30 21:25:50","2016-08-30 21:25:50"
566,8900,1461,1461,10361,1,"2016-08-30 21:25:50","2016-08-30 21:25:50"
567,8500,1447,0,8500,2,"2016-08-30 21:25:50","2016-08-30 21:25:50"
568,8500,1557,0,8500,2,"2016-08-30 21:25:50","2016-08-30 21:25:50"
569,8000,1536,1536,9536,1,"2016-08-30 21:25:50","2016-08-30 21:25:50"
570,7000,1465,1465,8465,1,"2016-08-30 21:25:50","2016-08-30 21:25:50"
571,9000,1560,1560,10560,1,"2016-08-30 21:25:50","2016-08-30 21:25:50"
572,7000,1449,1449,8449,2,"2016-08-30 21:25:50","2016-08-30 21:25:50"
573,7000,1354,1354,8354,1,"2016-08-30 21:25:50","2016-08-30 21:25:50"
574,8000,1534,1534,9534,2,"2016-08-30 21:25:50","2016-08-30 21:25:50"
575,8000,1562,0,8000,2,"2016-08-30 21:25:50","2016-08-30 21:25:50"
576,4000,1226,1226,5226,1,"2016-08-30 21:25:50","2016-08-30 21:25:50"
577,8500,1606,0,8500,2,"2016-08-30 21:25:50","2016-08-30 21:25:50"
578,8900,1460,0,8900,2,"2016-08-30 21:25:50","2016-08-30 21:25:50"
579,8000,1534,0,8000,2,"2016-08-30 21:25:50","2016-08-30 21:25:50"
580,8000,1424,0,8000,2,"2016-08-30 21:25:50","2016-08-30 21:25:50"
581,8000,1541,1541,9541,1,"2016-08-30 21:25:50","2016-08-30 21:25:50"
582,9900,1578,0,9900,2,"2016-08-30 21:25:50","2016-08-30 21:25:50"
583,4000,1294,1294,5294,1,"2016-08-30 21:25:50","2016-08-30 21:25:50"
584,8000,1492,1492,9492,1,"2016-08-30 21:25:50","2016-08-30 21:25:50"
585,8900,1467,1467,10367,1,"2016-08-30 21:25:50","2016-08-30 21:25:50"
586,8000,1422,1422,9422,2,"2016-08-30 21:25:50","2016-08-30 21:25:50"
587,8000,1526,0,8000,2,"2016-08-30 21:25:50","2016-08-30 21:25:50"
588,8000,1512,1512,9512,1,"2016-08-30 21:25:50","2016-08-30 21:25:50"
589,7000,1449,1449,8449,2,"2016-08-30 21:25:50","2016-08-30 21:25:50"
590,8900,1475,1475,10375,2,"2016-08-30 21:25:50","2016-08-30 21:25:50"
591,4000,1232,1232,5232,1,"2016-08-30 21:25:50","2016-08-30 21:25:50"
592,9500,1555,1555,11055,1,"2016-08-30 21:25:50","2016-08-30 21:25:50"
593,8000,1558,1558,9558,2,"2016-08-30 21:25:50","2016-08-30 21:25:50"
594,8000,1406,1406,9406,2,"2016-08-30 21:25:50","2016-08-30 21:25:50"
595,5000,1297,1297,6297,1,"2016-08-30 21:25:50","2016-08-30 21:25:50"
596,8900,1507,1507,10407,1,"2016-08-30 21:25:50","2016-08-30 21:25:50"
597,5000,1275,1275,6275,2,"2016-08-30 21:25:50","2016-08-30 21:25:50"
598,7000,1466,1466,8466,2,"2016-08-30 21:25:50","2016-08-30 21:25:50"
599,8900,1514,1514,10414,1,"2016-08-30 21:25:50","2016-08-30 21:25:50"
600,8000,1406,0,8000,2,"2016-08-30 21:25:50","2016-08-30 21:25:50"
601,8000,1577,1577,9577,1,"2016-08-30 21:25:50","2016-08-30 21:25:50"
602,8900,1602,1602,10502,1,"2016-08-30 21:25:50","2016-08-30 21:25:50"
603,8000,1403,0,8000,2,"2016-08-30 21:25:50","2016-08-30 21:25:50"
604,9000,1500,1500,10500,1,"2016-08-30 21:25:50","2016-08-30 21:25:50"
605,4000,1218,1218,5218,2,"2016-08-30 21:25:50","2016-08-30 21:25:50"
606,8500,1608,0,8500,2,"2016-08-30 21:25:50","2016-08-30 21:25:50"
607,8000,1575,0,8000,2,"2016-08-30 21:25:50","2016-08-30 21:25:50"
608,4000,1254,1254,5254,1,"2016-08-30 21:25:50","2016-08-30 21:25:50"
609,9000,1503,1503,10503,1,"2016-08-30 21:25:50","2016-08-30 21:25:50"
610,6000,1431,1431,7431,1,"2016-08-30 21:25:50","2016-08-30 21:25:50"
611,8900,1567,0,8900,2,"2016-08-30 21:25:50","2016-08-30 21:25:50"
612,8000,1424,1424,9424,1,"2016-08-30 21:25:50","2016-08-30 21:25:50"
613,6000,1497,1497,7497,1,"2016-08-30 21:25:50","2016-08-30 21:25:50"
614,9500,1539,1539,11039,1,"2016-08-30 21:25:50","2016-08-30 21:25:50"
615,8900,1555,0,8900,2,"2016-08-30 21:25:50","2016-08-30 21:25:50"
616,8500,1455,1455,9955,2,"2016-08-30 21:25:50","2016-08-30 21:25:50"
617,4000,1293,1293,5293,1,"2016-08-30 21:25:50","2016-08-30 21:25:50"
618,8000,1483,1483,9483,2,"2016-08-30 21:25:50","2016-08-30 21:25:50"
619,7000,1547,1547,8547,1,"2016-08-30 21:25:50","2016-08-30 21:25:50"
620,9900,1495,1495,11395,1,"2016-08-30 21:25:50","2016-08-30 21:25:50"
621,8000,1436,1436,9436,1,"2016-08-30 21:25:50","2016-08-30 21:25:50"
622,8900,1626,0,8900,2,"2016-08-30 21:25:50","2016-08-30 21:25:50"
623,8000,1575,1575,9575,2,"2016-08-30 21:25:50","2016-08-30 21:25:50"
624,4000,1278,1278,5278,2,"2016-08-30 21:25:50","2016-08-30 21:25:50"
625,5000,1329,1329,6329,1,"2016-08-30 21:25:50","2016-08-30 21:25:50"
626,9000,1590,1590,10590,1,"2016-08-30 21:25:50","2016-08-30 21:25:50"
627,8900,1618,0,8900,2,"2016-08-30 21:25:50","2016-08-30 21:25:50"
628,8000,1444,0,8000,2,"2016-08-30 21:25:50","2016-08-30 21:25:50"
629,8000,1449,0,8000,2,"2016-08-30 21:25:50","2016-08-30 21:25:50"
630,5000,1447,1447,6447,1,"2016-08-30 21:25:50","2016-08-30 21:25:50"
631,4000,1305,1305,5305,1,"2016-08-30 21:25:50","2016-08-30 21:25:50"
632,8000,1561,0,8000,2,"2016-08-30 21:25:50","2016-08-30 21:25:50"
633,9000,1498,1498,10498,1,"2016-08-30 21:25:50","2016-08-30 21:25:50"
634,9500,1597,0,9500,2,"2016-08-30 21:25:50","2016-08-30 21:25:50"
635,7000,1477,1477,8477,1,"2016-08-30 21:25:50","2016-08-30 21:25:50"
636,8000,1560,0,8000,2,"2016-08-30 21:25:50","2016-08-30 21:25:50"
637,9900,1584,1584,11484,1,"2016-08-30 21:25:50","2016-08-30 21:25:50"
638,8000,1490,0,8000,2,"2016-08-30 21:25:50","2016-08-30 21:25:50"
639,5000,1416,1416,6416,1,"2016-08-30 21:25:50","2016-08-30 21:25:50"
640,8500,1551,1551,10051,2,"2016-08-30 21:25:50","2016-08-30 21:25:50"
641,8500,1535,1535,10035,1,"2016-08-30 21:25:50","2016-08-30 21:25:50"
642,9900,1630,0,9900,2,"2016-08-30 21:25:50","2016-08-30 21:25:50"
643,9900,1588,1588,11488,1,"2016-08-30 21:25:50","2016-08-30 21:25:50"
644,7000,1537,1537,8537,1,"2016-08-30 21:25:50","2016-08-30 21:25:50"
645,8500,1483,0,8500,2,"2016-08-30 21:25:50","2016-08-30 21:25:50"
646,4000,1396,1396,5396,1,"2016-08-30 21:25:50","2016-08-30 21:25:50"
647,5000,1412,1412,6412,1,"2016-08-30 21:25:50","2016-08-30 21:25:50"
648,6000,1490,1490,7490,1,"2016-08-30 21:25:50","2016-08-30 21:25:50"
649,8500,1479,1479,9979,1,"2016-08-30 21:25:50","2016-08-30 21:25:50"
650,8000,1574,0,8000,2,"2016-08-30 21:25:50","2016-08-30 21:25:50"
651,8000,1588,1588,9588,2,"2016-08-30 21:25:50","2016-08-30 21:25:50"
652,8000,1572,1572,9572,2,"2016-08-30 21:25:50","2016-08-30 21:25:50"
653,8900,1473,1473,10373,2,"2016-08-30 21:25:50","2016-08-30 21:25:50"
654,8000,1462,1462,9462,1,"2016-08-30 21:25:50","2016-08-30 21:25:50"
655,4000,1376,1376,5376,1,"2016-08-30 21:25:50","2016-08-30 21:25:50"
656,8000,1418,0,8000,2,"2016-08-30 21:25:50","2016-08-30 21:25:50"
657,5000,1257,1257,6257,2,"2016-08-30 21:25:50","2016-08-30 21:25:50"
658,7000,1416,1416,8416,1,"2016-08-30 21:25:50","2016-08-30 21:25:50"
659,4000,1341,1341,5341,1,"2016-08-30 21:25:50","2016-08-30 21:25:50"
660,9500,1653,1653,11153,1,"2016-08-30 21:25:50","2016-08-30 21:25:50"
661,8000,1578,1578,9578,2,"2016-08-30 21:25:50","2016-08-30 21:25:50"
662,8500,1617,1617,10117,1,"2016-08-30 21:25:50","2016-08-30 21:25:50"
663,9500,1487,1487,10987,1,"2016-08-30 21:25:50","2016-08-30 21:25:50"
664,8000,1544,0,8000,2,"2016-08-30 21:25:50","2016-08-30 21:25:50"
665,5000,1365,1365,6365,1,"2016-08-30 21:25:50","2016-08-30 21:25:50"
666,5000,1250,1250,6250,1,"2016-08-30 21:25:50","2016-08-30 21:25:50"
667,5000,1302,1302,6302,2,"2016-08-30 21:25:50","2016-08-30 21:25:50"
668,5000,1449,1449,6449,1,"2016-08-30 21:25:50","2016-08-30 21:25:50"
669,6000,1327,1327,7327,1,"2016-08-30 21:25:50","2016-08-30 21:25:50"
670,6000,1383,1383,7383,2,"2016-08-30 21:25:50","2016-08-30 21:25:50"
671,7000,1497,1497,8497,1,"2016-08-30 21:25:50","2016-08-30 21:25:50"
672,8000,1476,0,8000,2,"2016-08-30 21:25:50","2016-08-30 21:25:50"
673,6000,1368,1368,7368,1,"2016-08-30 21:25:50","2016-08-30 21:25:50"
674,6000,1333,1333,7333,2,"2016-08-30 21:25:50","2016-08-30 21:25:50"
675,8900,1571,0,8900,2,"2016-08-30 21:25:50","2016-08-30 21:25:50"
676,8500,1575,1575,10075,1,"2016-08-30 21:25:50","2016-08-30 21:25:50"
677,8900,1477,0,8900,2,"2016-08-30 21:25:50","2016-08-30 21:25:50"
678,4000,1256,1256,5256,1,"2016-08-30 21:25:50","2016-08-30 21:25:50"
679,9900,1624,1624,11524,1,"2016-08-30 21:25:50","2016-08-30 21:25:50"
680,9000,1468,1468,10468,1,"2016-08-30 21:25:50","2016-08-30 21:25:50"
681,7000,1463,1463,8463,1,"2016-08-30 21:25:50","2016-08-30 21:25:50"
682,8000,1587,0,8000,2,"2016-08-30 21:25:50","2016-08-30 21:25:50"
683,8000,1477,0,8000,2,"2016-08-30 21:25:50","2016-08-30 21:25:50"
684,8900,1642,0,8900,2,"2016-08-30 21:25:50","2016-08-30 21:25:50"
685,7000,1364,1364,8364,1,"2016-08-30 21:25:50","2016-08-30 21:25:50"
686,4000,1323,1323,5323,2,"2016-08-30 21:25:50","2016-08-30 21:25:50"
687,8000,1415,1415,9415,2,"2016-08-30 21:25:50","2016-08-30 21:25:50"
688,8000,1403,0,8000,2,"2016-08-30 21:25:50","2016-08-30 21:25:50"
689,8900,1532,1532,10432,1,"2016-08-30 21:25:50","2016-08-30 21:25:50"
690,8000,1443,0,8000,2,"2016-08-30 21:25:50","2016-08-30 21:25:50"
691,4000,1248,1248,5248,1,"2016-08-30 21:25:50","2016-08-30 21:25:50"
692,8000,1466,0,8000,2,"2016-08-30 21:25:50","2016-08-30 21:25:50"
693,9500,1661,1661,11161,1,"2016-08-30 21:25:50","2016-08-30 21:25:50"
694,8000,1515,0,8000,2,"2016-08-30 21:25:50","2016-08-30 21:25:50"
695,8900,1568,1568,10468,1,"2016-08-30 21:25:50","2016-08-30 21:25:50"
696,4000,1347,1347,5347,1,"2016-08-30 21:25:50","2016-08-30 21:25:50"
697,8500,1489,0,8500,2,"2016-08-30 21:25:50","2016-08-30 21:25:50"
698,8500,1441,0,8500,2,"2016-08-30 21:25:50","2016-08-30 21:25:50"
699,4000,1389,1389,5389,1,"2016-08-30 21:25:50","2016-08-30 21:25:50"
700,8900,1604,0,8900,2,"2016-08-30 21:25:50","2016-08-30 21:25:50"
701,8900,1446,0,8900,2,"2016-08-30 21:25:50","2016-08-30 21:25:50"
702,4000,1361,1361,5361,1,"2016-08-30 21:25:50","2016-08-30 21:25:50"
703,4000,1230,1230,5230,1,"2016-08-30 21:25:50","2016-08-30 21:25:50"
704,5000,1424,1424,6424,1,"2016-08-30 21:25:50","2016-08-30 21:25:50"
705,8500,1433,0,8500,2,"2016-08-30 21:25:50","2016-08-30 21:25:50"
706,8000,1455,0,8000,2,"2016-08-30 21:25:50","2016-08-30 21:25:50"
707,5000,1381,1381,6381,2,"2016-08-30 21:25:50","2016-08-30 21:25:50"
708,8900,1446,0,8900,2,"2016-08-30 21:25:50","2016-08-30 21:25:50"
709,8000,1516,1516,9516,2,"2016-08-30 21:25:50","2016-08-30 21:25:50"
710,8000,1431,1431,9431,2,"2016-08-30 21:25:50","2016-08-30 21:25:50"
711,8000,1563,0,8000,2,"2016-08-30 21:25:50","2016-08-30 21:25:50"
712,9900,1642,1642,11542,1,"2016-08-30 21:25:50","2016-08-30 21:25:50"
713,9900,1645,1645,11545,1,"2016-08-30 21:25:50","2016-08-30 21:25:50"
714,5000,1257,1257,6257,1,"2016-08-30 21:25:50","2016-08-30 21:25:50"
715,4000,1359,1359,5359,1,"2016-08-30 21:25:50","2016-08-30 21:25:50"
716,9900,1583,1583,11483,1,"2016-08-30 21:25:50","2016-08-30 21:25:50"
717,8500,1559,1559,10059,1,"2016-08-30 21:25:50","2016-08-30 21:25:50"
718,8500,1577,0,8500,2,"2016-08-30 21:25:50","2016-08-30 21:25:50"
719,8500,1612,0,8500,2,"2016-08-30 21:25:50","2016-08-30 21:25:50"
720,9900,1497,1497,11397,1,"2016-08-30 21:25:50","2016-08-30 21:25:50"
721,8000,1579,1579,9579,1,"2016-08-30 21:25:50","2016-08-30 21:25:50"
722,9000,1564,1564,10564,1,"2016-08-30 21:25:50","2016-08-30 21:25:50"
723,8000,1486,1486,9486,2,"2016-08-30 21:25:50","2016-08-30 21:25:50"
724,8000,1564,0,8000,2,"2016-08-30 21:25:50","2016-08-30 21:25:50"
725,8900,1560,1560,10460,1,"2016-08-30 21:25:50","2016-08-30 21:25:50"
726,8500,1503,1503,10003,1,"2016-08-30 21:25:50","2016-08-30 21:25:50"
727,8000,1485,0,8000,2,"2016-08-30 21:25:50","2016-08-30 21:25:50"
728,5000,1257,1257,6257,1,"2016-08-30 21:25:50","2016-08-30 21:25:50"
729,8000,1520,0,8000,2,"2016-08-30 21:25:50","2016-08-30 21:25:50"
730,4000,1332,1332,5332,1,"2016-08-30 21:25:50","2016-08-30 21:25:50"
731,5000,1297,1297,6297,1,"2016-08-30 21:25:50","2016-08-30 21:25:50"
732,8900,1490,0,8900,2,"2016-08-30 21:25:50","2016-08-30 21:25:50"
733,7000,1373,1373,8373,1,"2016-08-30 21:25:50","2016-08-30 21:25:50"
734,9500,1476,0,9500,2,"2016-08-30 21:25:50","2016-08-30 21:25:50"
735,5000,1392,1392,6392,1,"2016-08-30 21:25:50","2016-08-30 21:25:50"
736,9500,1554,1554,11054,1,"2016-08-30 21:25:50","2016-08-30 21:25:50"
737,8500,1596,0,8500,2,"2016-08-30 21:25:50","2016-08-30 21:25:50"
738,8900,1507,1507,10407,2,"2016-08-30 21:25:50","2016-08-30 21:25:50"
739,8900,1482,0,8900,2,"2016-08-30 21:25:50","2016-08-30 21:25:50"
740,4000,1341,1341,5341,1,"2016-08-30 21:25:50","2016-08-30 21:25:50"
741,8000,1533,1533,9533,1,"2016-08-30 21:25:50","2016-08-30 21:25:50"
742,8900,1634,1634,10534,1,"2016-08-30 21:25:50","2016-08-30 21:25:50"
743,7000,1521,1521,8521,1,"2016-08-30 21:25:50","2016-08-30 21:25:50"
744,8000,1531,1531,9531,2,"2016-08-30 21:25:50","2016-08-30 21:25:50"
745,8000,1581,1581,9581,1,"2016-08-30 21:25:50","2016-08-30 21:25:50"
746,8500,1491,0,8500,2,"2016-08-30 21:25:50","2016-08-30 21:25:50"
747,9900,1500,1500,11400,1,"2016-08-30 21:25:50","2016-08-30 21:25:50"
748,8500,1586,0,8500,2,"2016-08-30 21:25:50","2016-08-30 21:25:50"
749,4000,1366,1366,5366,2,"2016-08-30 21:25:50","2016-08-30 21:25:50"
750,4000,1328,1328,5328,1,"2016-08-30 21:25:50","2016-08-30 21:25:50"
751,9500,1490,0,9500,2,"2016-08-30 21:25:50","2016-08-30 21:25:50"
752,4000,1304,1304,5304,1,"2016-08-30 21:25:50","2016-08-30 21:25:50"
753,5000,1338,1338,6338,1,"2016-08-30 21:25:50","2016-08-30 21:25:50"
754,9900,1659,1659,11559,1,"2016-08-30 21:25:50","2016-08-30 21:25:50"
755,8000,1508,0,8000,2,"2016-08-30 21:25:50","2016-08-30 21:25:50"
756,8900,1478,1478,10378,1,"2016-08-30 21:25:50","2016-08-30 21:25:50"
757,7000,1547,1547,8547,2,"2016-08-30 21:25:50","2016-08-30 21:25:50"
758,4000,1229,1229,5229,2,"2016-08-30 21:25:50","2016-08-30 21:25:50"
759,8000,1506,0,8000,2,"2016-08-30 21:25:50","2016-08-30 21:25:50"
760,6000,1493,1493,7493,1,"2016-08-30 21:25:50","2016-08-30 21:25:50"
761,4000,1385,1385,5385,1,"2016-08-30 21:25:50","2016-08-30 21:25:50"
762,8900,1547,0,8900,2,"2016-08-30 21:25:50","2016-08-30 21:25:50"
763,8500,1450,1450,9950,1,"2016-08-30 21:25:50","2016-08-30 21:25:50"
764,8000,1462,0,8000,2,"2016-08-30 21:25:50","2016-08-30 21:25:50"
765,8000,1515,1515,9515,1,"2016-08-30 21:25:50","2016-08-30 21:25:50"
766,8900,1607,0,8900,2,"2016-08-30 21:25:50","2016-08-30 21:25:50"
767,8500,1511,0,8500,2,"2016-08-30 21:25:50","2016-08-30 21:25:50"
768,8900,1543,0,8900,2,"2016-08-30 21:25:50","2016-08-30 21:25:50"
769,8500,1534,1534,10034,1,"2016-08-30 21:25:50","2016-08-30 21:25:50"
770,8500,1589,1589,10089,2,"2016-08-30 21:25:50","2016-08-30 21:25:50"
771,8900,1637,0,8900,2,"2016-08-30 21:25:50","2016-08-30 21:25:50"
772,8000,1442,0,8000,2,"2016-08-30 21:25:50","2016-08-30 21:25:50"
773,9000,1487,0,9000,2,"2016-08-30 21:25:50","2016-08-30 21:25:50"
774,8500,1470,0,8500,2,"2016-08-30 21:25:50","2016-08-30 21:25:50"
775,9500,1648,1648,11148,2,"2016-08-30 21:25:50","2016-08-30 21:25:50"
776,5000,1317,1317,6317,1,"2016-08-30 21:25:50","2016-08-30 21:25:50"
777,8000,1595,1595,9595,1,"2016-08-30 21:25:50","2016-08-30 21:25:50"
778,9000,1628,1628,10628,1,"2016-08-30 21:25:50","2016-08-30 21:25:50"
779,8000,1454,1454,9454,1,"2016-08-30 21:25:50","2016-08-30 21:25:50"
780,8000,1435,1435,9435,1,"2016-08-30 21:25:50","2016-08-30 21:25:50"
781,8500,1519,1519,10019,1,"2016-08-30 21:25:50","2016-08-30 21:25:50"
782,9500,1672,1672,11172,1,"2016-08-30 21:25:50","2016-08-30 21:25:50"
783,9900,1598,1598,11498,1,"2016-08-30 21:25:50","2016-08-30 21:25:50"
784,9500,1668,1668,11168,1,"2016-08-30 21:25:50","2016-08-30 21:25:50"
785,4000,1379,1379,5379,1,"2016-08-30 21:25:51","2016-08-30 21:25:51"
786,8000,1587,1587,9587,1,"2016-08-30 21:25:51","2016-08-30 21:25:51"
787,8500,1525,0,8500,2,"2016-08-30 21:25:51","2016-08-30 21:25:51"
788,9900,1645,1645,11545,1,"2016-08-30 21:25:51","2016-08-30 21:25:51"
789,8000,1488,0,8000,2,"2016-08-30 21:25:51","2016-08-30 21:25:51"
790,8000,1514,0,8000,2,"2016-08-30 21:25:51","2016-08-30 21:25:51"
791,8500,1459,1459,9959,1,"2016-08-30 21:25:51","2016-08-30 21:25:51"
792,7000,1467,1467,8467,1,"2016-08-30 21:25:51","2016-08-30 21:25:51"
793,7000,1533,1533,8533,1,"2016-08-30 21:25:51","2016-08-30 21:25:51"
794,8900,1622,0,8900,2,"2016-08-30 21:25:51","2016-08-30 21:25:51"
795,5000,1294,1294,6294,1,"2016-08-30 21:25:51","2016-08-30 21:25:51"
796,5000,1426,1426,6426,2,"2016-08-30 21:25:51","2016-08-30 21:25:51"
797,9500,1538,0,9500,2,"2016-08-30 21:25:51","2016-08-30 21:25:51"
798,9000,1513,0,9000,2,"2016-08-30 21:25:51","2016-08-30 21:25:51"
799,8000,1416,1416,9416,2,"2016-08-30 21:25:51","2016-08-30 21:25:51"
800,9500,1582,1582,11082,1,"2016-08-30 21:25:51","2016-08-30 21:25:51"
801,4000,1205,1205,5205,2,"2016-08-30 21:25:51","2016-08-30 21:25:51"
802,4000,1252,1252,5252,1,"2016-08-30 21:25:51","2016-08-30 21:25:51"
803,8500,1503,1503,10003,2,"2016-08-30 21:25:51","2016-08-30 21:25:51"
804,8500,1517,1517,10017,2,"2016-08-30 21:25:51","2016-08-30 21:25:51"
805,8000,1531,1531,9531,1,"2016-08-30 21:25:51","2016-08-30 21:25:51"
806,4000,1264,1264,5264,1,"2016-08-30 21:25:51","2016-08-30 21:25:51"
807,8900,1588,0,8900,2,"2016-08-30 21:25:51","2016-08-30 21:25:51"
808,9500,1590,1590,11090,1,"2016-08-30 21:25:51","2016-08-30 21:25:51"
809,7000,1446,1446,8446,1,"2016-08-30 21:25:51","2016-08-30 21:25:51"
810,8900,1626,1626,10526,2,"2016-08-30 21:25:51","2016-08-30 21:25:51"
811,8000,1433,0,8000,2,"2016-08-30 21:25:51","2016-08-30 21:25:51"
812,8000,1411,0,8000,2,"2016-08-30 21:25:51","2016-08-30 21:25:51"
813,8000,1577,1577,9577,1,"2016-08-30 21:25:51","2016-08-30 21:25:51"
814,5000,1354,1354,6354,2,"2016-08-30 21:25:51","2016-08-30 21:25:51"
815,8500,1488,0,8500,2,"2016-08-30 21:25:51","2016-08-30 21:25:51"
816,6000,1371,1371,7371,1,"2016-08-30 21:25:51","2016-08-30 21:25:51"
817,8000,1574,0,8000,2,"2016-08-30 21:25:51","2016-08-30 21:25:51"
818,8500,1433,0,8500,2,"2016-08-30 21:25:51","2016-08-30 21:25:51"
819,8000,1489,0,8000,2,"2016-08-30 21:25:51","2016-08-30 21:25:51"
820,8500,1487,0,8500,2,"2016-08-30 21:25:51","2016-08-30 21:25:51"
821,4000,1379,1379,5379,1,"2016-08-30 21:25:51","2016-08-30 21:25:51"
822,8900,1606,0,8900,2,"2016-08-30 21:25:51","2016-08-30 21:25:51"
823,8900,1589,1589,10489,1,"2016-08-30 21:25:51","2016-08-30 21:25:51"
824,9000,1582,1582,10582,1,"2016-08-30 21:25:51","2016-08-30 21:25:51"
825,9900,1657,0,9900,2,"2016-08-30 21:25:51","2016-08-30 21:25:51"
826,8000,1576,0,8000,2,"2016-08-30 21:25:51","2016-08-30 21:25:51"
827,8500,1607,1607,10107,2,"2016-08-30 21:25:51","2016-08-30 21:25:51"
828,4000,1225,1225,5225,1,"2016-08-30 21:25:51","2016-08-30 21:25:51"
829,8500,1546,1546,10046,2,"2016-08-30 21:25:51","2016-08-30 21:25:51"
830,6000,1422,1422,7422,1,"2016-08-30 21:25:51","2016-08-30 21:25:51"
831,8500,1611,1611,10111,2,"2016-08-30 21:25:51","2016-08-30 21:25:51"
832,9000,1464,1464,10464,1,"2016-08-30 21:25:51","2016-08-30 21:25:51"
833,8500,1557,0,8500,2,"2016-08-30 21:25:51","2016-08-30 21:25:51"
834,8500,1456,0,8500,2,"2016-08-30 21:25:51","2016-08-30 21:25:51"
835,5000,1293,1293,6293,2,"2016-08-30 21:25:51","2016-08-30 21:25:51"
836,8500,1494,1494,9994,2,"2016-08-30 21:25:51","2016-08-30 21:25:51"
837,8900,1609,0,8900,2,"2016-08-30 21:25:51","2016-08-30 21:25:51"
838,7000,1458,1458,8458,2,"2016-08-30 21:25:51","2016-08-30 21:25:51"
839,8500,1498,1498,9998,1,"2016-08-30 21:25:51","2016-08-30 21:25:51"
840,8000,1539,1539,9539,2,"2016-08-30 21:25:51","2016-08-30 21:25:51"
841,8900,1594,0,8900,2,"2016-08-30 21:25:51","2016-08-30 21:25:51"
842,8000,1506,0,8000,2,"2016-08-30 21:25:51","2016-08-30 21:25:51"
843,8000,1562,0,8000,2,"2016-08-30 21:25:51","2016-08-30 21:25:51"
844,8000,1429,0,8000,2,"2016-08-30 21:25:51","2016-08-30 21:25:51"
845,8900,1565,0,8900,2,"2016-08-30 21:25:51","2016-08-30 21:25:51"
846,4000,1309,1309,5309,2,"2016-08-30 21:25:51","2016-08-30 21:25:51"
847,8000,1491,1491,9491,2,"2016-08-30 21:25:51","2016-08-30 21:25:51"
848,5000,1392,1392,6392,1,"2016-08-30 21:25:51","2016-08-30 21:25:51"
849,8000,1572,0,8000,2,"2016-08-30 21:25:51","2016-08-30 21:25:51"
850,8000,1481,0,8000,2,"2016-08-30 21:25:51","2016-08-30 21:25:51"
851,8500,1619,0,8500,2,"2016-08-30 21:25:51","2016-08-30 21:25:51"
852,8000,1431,1431,9431,1,"2016-08-30 21:25:51","2016-08-30 21:25:51"
853,9900,1646,1646,11546,1,"2016-08-30 21:25:51","2016-08-30 21:25:51"
854,5000,1444,1444,6444,1,"2016-08-30 21:25:51","2016-08-30 21:25:51"
855,8500,1587,0,8500,2,"2016-08-30 21:25:51","2016-08-30 21:25:51"
856,8500,1573,1573,10073,1,"2016-08-30 21:25:51","2016-08-30 21:25:51"
857,8500,1515,1515,10015,1,"2016-08-30 21:25:51","2016-08-30 21:25:51"
858,8000,1587,0,8000,2,"2016-08-30 21:25:51","2016-08-30 21:25:51"
859,6000,1361,1361,7361,1,"2016-08-30 21:25:51","2016-08-30 21:25:51"
860,8000,1549,0,8000,2,"2016-08-30 21:25:51","2016-08-30 21:25:51"
861,8500,1605,1605,10105,1,"2016-08-30 21:25:51","2016-08-30 21:25:51"
862,8500,1459,0,8500,2,"2016-08-30 21:25:51","2016-08-30 21:25:51"
863,4000,1205,1205,5205,1,"2016-08-30 21:25:51","2016-08-30 21:25:51"
864,5000,1350,1350,6350,1,"2016-08-30 21:25:51","2016-08-30 21:25:51"
865,9900,1520,1520,11420,1,"2016-08-30 21:25:51","2016-08-30 21:25:51"
866,4000,1214,1214,5214,1,"2016-08-30 21:25:51","2016-08-30 21:25:51"
867,9900,1503,1503,11403,1,"2016-08-30 21:25:51","2016-08-30 21:25:51"
868,8500,1504,0,8500,2,"2016-08-30 21:25:51","2016-08-30 21:25:51"
869,8000,1597,1597,9597,1,"2016-08-30 21:25:51","2016-08-30 21:25:51"
870,8000,1443,0,8000,2,"2016-08-30 21:25:51","2016-08-30 21:25:51"
871,8000,1586,0,8000,2,"2016-08-30 21:25:51","2016-08-30 21:25:51"
872,4000,1240,1240,5240,2,"2016-08-30 21:25:51","2016-08-30 21:25:51"
873,8900,1464,0,8900,2,"2016-08-30 21:25:51","2016-08-30 21:25:51"
874,8500,1581,1581,10081,2,"2016-08-30 21:25:51","2016-08-30 21:25:51"
875,4000,1351,1351,5351,1,"2016-08-30 21:25:51","2016-08-30 21:25:51"
876,8000,1588,1588,9588,2,"2016-08-30 21:25:51","2016-08-30 21:25:51"
877,5000,1343,1343,6343,1,"2016-08-30 21:25:51","2016-08-30 21:25:51"
878,8900,1591,1591,10491,1,"2016-08-30 21:25:51","2016-08-30 21:25:51"
879,4000,1342,1342,5342,1,"2016-08-30 21:25:51","2016-08-30 21:25:51"
880,8900,1618,0,8900,2,"2016-08-30 21:25:51","2016-08-30 21:25:51"
881,8000,1545,0,8000,2,"2016-08-30 21:25:51","2016-08-30 21:25:51"
882,4000,1216,1216,5216,1,"2016-08-30 21:25:51","2016-08-30 21:25:51"
883,9000,1585,1585,10585,1,"2016-08-30 21:25:51","2016-08-30 21:25:51"
884,6000,1337,1337,7337,2,"2016-08-30 21:25:51","2016-08-30 21:25:51"
885,8500,1468,0,8500,2,"2016-08-30 21:25:51","2016-08-30 21:25:51"
886,4000,1317,1317,5317,1,"2016-08-30 21:25:51","2016-08-30 21:25:51"
887,5000,1289,1289,6289,1,"2016-08-30 21:25:51","2016-08-30 21:25:51"
888,4000,1231,1231,5231,1,"2016-08-30 21:25:51","2016-08-30 21:25:51"
889,9900,1519,1519,11419,1,"2016-08-30 21:25:51","2016-08-30 21:25:51"
890,8000,1445,0,8000,2,"2016-08-30 21:25:51","2016-08-30 21:25:51"
891,8000,1562,1562,9562,2,"2016-08-30 21:25:51","2016-08-30 21:25:51"
892,4000,1395,1395,5395,1,"2016-08-30 21:25:51","2016-08-30 21:25:51"
893,8500,1428,0,8500,2,"2016-08-30 21:25:51","2016-08-30 21:25:51"
894,8000,1482,1482,9482,1,"2016-08-30 21:25:51","2016-08-30 21:25:51"
895,8000,1564,1564,9564,1,"2016-08-30 21:25:51","2016-08-30 21:25:51"
896,8000,1426,1426,9426,1,"2016-08-30 21:25:51","2016-08-30 21:25:51"
897,8000,1536,0,8000,2,"2016-08-30 21:25:51","2016-08-30 21:25:51"
898,8900,1469,1469,10369,2,"2016-08-30 21:25:51","2016-08-30 21:25:51"
899,9900,1590,1590,11490,1,"2016-08-30 21:25:51","2016-08-30 21:25:51"
900,8900,1558,0,8900,2,"2016-08-30 21:25:51","2016-08-30 21:25:51"
901,8000,1487,1487,9487,1,"2016-08-30 21:25:51","2016-08-30 21:25:51"
902,8900,1457,1457,10357,2,"2016-08-30 21:25:51","2016-08-30 21:25:51"
903,8500,1544,0,8500,2,"2016-08-30 21:25:51","2016-08-30 21:25:51"
904,9500,1629,1629,11129,1,"2016-08-30 21:25:51","2016-08-30 21:25:51"
905,4000,1314,1314,5314,1,"2016-08-30 21:25:51","2016-08-30 21:25:51"
906,9500,1504,1504,11004,1,"2016-08-30 21:25:51","2016-08-30 21:25:51"
907,8900,1560,1560,10460,1,"2016-08-30 21:25:51","2016-08-30 21:25:51"
908,8000,1493,0,8000,2,"2016-08-30 21:25:51","2016-08-30 21:25:51"
909,8500,1528,0,8500,2,"2016-08-30 21:25:51","2016-08-30 21:25:51"
910,5000,1298,1298,6298,1,"2016-08-30 21:25:51","2016-08-30 21:25:51"
911,8000,1586,0,8000,2,"2016-08-30 21:25:51","2016-08-30 21:25:51"
912,9900,1530,0,9900,2,"2016-08-30 21:25:51","2016-08-30 21:25:51"
913,5000,1315,1315,6315,1,"2016-08-30 21:25:51","2016-08-30 21:25:51"
914,5000,1412,1412,6412,2,"2016-08-30 21:25:51","2016-08-30 21:25:51"
915,7000,1529,1529,8529,1,"2016-08-30 21:25:51","2016-08-30 21:25:51"
916,9000,1451,1451,10451,1,"2016-08-30 21:25:51","2016-08-30 21:25:51"
917,9000,1484,1484,10484,1,"2016-08-30 21:25:51","2016-08-30 21:25:51"
918,5000,1263,1263,6263,1,"2016-08-30 21:25:51","2016-08-30 21:25:51"
919,5000,1411,1411,6411,2,"2016-08-30 21:25:51","2016-08-30 21:25:51"
920,8500,1594,0,8500,2,"2016-08-30 21:25:51","2016-08-30 21:25:51"
921,8000,1474,0,8000,2,"2016-08-30 21:25:51","2016-08-30 21:25:51"
922,8900,1555,1555,10455,2,"2016-08-30 21:25:51","2016-08-30 21:25:51"
923,4000,1293,1293,5293,1,"2016-08-30 21:25:51","2016-08-30 21:25:51"
924,4000,1307,1307,5307,2,"2016-08-30 21:25:51","2016-08-30 21:25:51"
925,4000,1343,1343,5343,2,"2016-08-30 21:25:51","2016-08-30 21:25:51"
926,8900,1577,1577,10477,1,"2016-08-30 21:25:51","2016-08-30 21:25:51"
927,4000,1302,1302,5302,1,"2016-08-30 21:25:51","2016-08-30 21:25:51"
928,8000,1591,0,8000,2,"2016-08-30 21:25:51","2016-08-30 21:25:51"
929,5000,1406,1406,6406,2,"2016-08-30 21:25:51","2016-08-30 21:25:51"
930,8500,1427,0,8500,2,"2016-08-30 21:25:51","2016-08-30 21:25:51"
931,9000,1629,1629,10629,1,"2016-08-30 21:25:51","2016-08-30 21:25:51"
932,9500,1532,1532,11032,1,"2016-08-30 21:25:51","2016-08-30 21:25:51"
933,9900,1603,1603,11503,1,"2016-08-30 21:25:51","2016-08-30 21:25:51"
934,9900,1503,1503,11403,1,"2016-08-30 21:25:51","2016-08-30 21:25:51"
935,9900,1541,1541,11441,1,"2016-08-30 21:25:51","2016-08-30 21:25:51"
936,8000,1518,0,8000,2,"2016-08-30 21:25:51","2016-08-30 21:25:51"
937,8000,1589,0,8000,2,"2016-08-30 21:25:51","2016-08-30 21:25:51"
938,9900,1583,1583,11483,1,"2016-08-30 21:25:51","2016-08-30 21:25:51"
939,8000,1588,0,8000,2,"2016-08-30 21:25:51","2016-08-30 21:25:51"
940,8500,1598,0,8500,2,"2016-08-30 21:25:51","2016-08-30 21:25:51"
941,8900,1573,1573,10473,1,"2016-08-30 21:25:51","2016-08-30 21:25:51"
942,9900,1527,1527,11427,1,"2016-08-30 21:25:51","2016-08-30 21:25:51"
943,8500,1589,0,8500,2,"2016-08-30 21:25:51","2016-08-30 21:25:51"
944,4000,1252,1252,5252,1,"2016-08-30 21:25:51","2016-08-30 21:25:51"
945,9000,1535,1535,10535,1,"2016-08-30 21:25:51","2016-08-30 21:25:51"
946,5000,1295,1295,6295,1,"2016-08-30 21:25:51","2016-08-30 21:25:51"
947,5000,1300,1300,6300,1,"2016-08-30 21:25:51","2016-08-30 21:25:51"
948,8000,1545,0,8000,2,"2016-08-30 21:25:51","2016-08-30 21:25:51"
949,9500,1483,1483,10983,2,"2016-08-30 21:25:51","2016-08-30 21:25:51"
950,8000,1591,0,8000,2,"2016-08-30 21:25:51","2016-08-30 21:25:51"
951,8900,1610,0,8900,2,"2016-08-30 21:25:51","2016-08-30 21:25:51"
952,7000,1467,1467,8467,1,"2016-08-30 21:25:51","2016-08-30 21:25:51"
953,5000,1293,1293,6293,2,"2016-08-30 21:25:51","2016-08-30 21:25:51"
954,7000,1477,1477,8477,2,"2016-08-30 21:25:51","2016-08-30 21:25:51"
955,5000,1430,1430,6430,1,"2016-08-30 21:25:51","2016-08-30 21:25:51"
956,9900,1597,1597,11497,1,"2016-08-30 21:25:51","2016-08-30 21:25:51"
957,8000,1425,1425,9425,1,"2016-08-30 21:25:51","2016-08-30 21:25:51"
958,8900,1644,0,8900,2,"2016-08-30 21:25:51","2016-08-30 21:25:51"
959,8000,1469,1469,9469,1,"2016-08-30 21:25:51","2016-08-30 21:25:51"
960,7000,1530,1530,8530,1,"2016-08-30 21:25:51","2016-08-30 21:25:51"
961,8000,1532,1532,9532,1,"2016-08-30 21:25:51","2016-08-30 21:25:51"
962,5000,1289,1289,6289,2,"2016-08-30 21:25:51","2016-08-30 21:25:51"
963,8900,1477,1477,10377,1,"2016-08-30 21:25:51","2016-08-30 21:25:51"
964,8900,1626,0,8900,2,"2016-08-30 21:25:51","2016-08-30 21:25:51"
965,9500,1603,1603,11103,1,"2016-08-30 21:25:51","2016-08-30 21:25:51"
966,8000,1597,1597,9597,2,"2016-08-30 21:25:51","2016-08-30 21:25:51"
967,7000,1367,1367,8367,1,"2016-08-30 21:25:51","2016-08-30 21:25:51"
968,8000,1495,0,8000,2,"2016-08-30 21:25:51","2016-08-30 21:25:51"
969,9500,1572,0,9500,2,"2016-08-30 21:25:51","2016-08-30 21:25:51"
970,7000,1495,1495,8495,1,"2016-08-30 21:25:51","2016-08-30 21:25:51"
971,5000,1274,1274,6274,2,"2016-08-30 21:25:51","2016-08-30 21:25:51"
972,5000,1427,1427,6427,1,"2016-08-30 21:25:51","2016-08-30 21:25:51"
973,8500,1430,0,8500,2,"2016-08-30 21:25:51","2016-08-30 21:25:51"
974,8900,1590,0,8900,2,"2016-08-30 21:25:51","2016-08-30 21:25:51"
975,4000,1265,1265,5265,1,"2016-08-30 21:25:51","2016-08-30 21:25:51"
976,8900,1523,1523,10423,2,"2016-08-30 21:25:51","2016-08-30 21:25:51"
977,8900,1517,0,8900,2,"2016-08-30 21:25:51","2016-08-30 21:25:51"
978,8000,1503,0,8000,2,"2016-08-30 21:25:51","2016-08-30 21:25:51"
979,8000,1592,0,8000,2,"2016-08-30 21:25:51","2016-08-30 21:25:51"
980,9900,1508,1508,11408,1,"2016-08-30 21:25:51","2016-08-30 21:25:51"
981,5000,1286,1286,6286,1,"2016-08-30 21:25:51","2016-08-30 21:25:51"
982,8500,1552,0,8500,2,"2016-08-30 21:25:51","2016-08-30 21:25:51"
983,8000,1528,0,8000,2,"2016-08-30 21:25:51","2016-08-30 21:25:51"
984,5000,1266,1266,6266,2,"2016-08-30 21:25:51","2016-08-30 21:25:51"
985,8900,1641,1641,10541,2,"2016-08-30 21:25:51","2016-08-30 21:25:51"
986,6000,1341,1341,7341,1,"2016-08-30 21:25:51","2016-08-30 21:25:51"
987,8500,1600,0,8500,2,"2016-08-30 21:25:51","2016-08-30 21:25:51"
988,8000,1467,1467,9467,1,"2016-08-30 21:25:51","2016-08-30 21:25:51"
989,8000,1590,1590,9590,1,"2016-08-30 21:25:51","2016-08-30 21:25:51"
990,8900,1603,1603,10503,2,"2016-08-30 21:25:51","2016-08-30 21:25:51"
991,9500,1528,0,9500,2,"2016-08-30 21:25:51","2016-08-30 21:25:51"
992,4000,1393,1393,5393,1,"2016-08-30 21:25:51","2016-08-30 21:25:51"
993,6000,1359,1359,7359,1,"2016-08-30 21:25:51","2016-08-30 21:25:51"
994,8500,1532,0,8500,2,"2016-08-30 21:25:51","2016-08-30 21:25:51"
995,5000,1353,1353,6353,2,"2016-08-30 21:25:51","2016-08-30 21:25:51"
996,8900,1579,1579,10479,1,"2016-08-30 21:25:51","2016-08-30 21:25:51"
997,8900,1553,1553,10453,1,"2016-08-30 21:25:51","2016-08-30 21:25:51"
998,8500,1456,1456,9956,1,"2016-08-30 21:25:51","2016-08-30 21:25:51"
999,8000,1409,1409,9409,1,"2016-08-30 21:25:51","2016-08-30 21:25:51"
1000,5000,1390,1390,6390,1,"2016-08-30 21:25:51","2016-08-30 21:25:51"
1001,5000,1430,1430,6430,1,"2016-08-30 21:25:51","2016-08-30 21:25:51"
1002,8000,1440,0,8000,2,"2016-08-30 21:25:51","2016-08-30 21:25:51"
1003,9900,1582,0,9900,2,"2016-08-30 21:25:51","2016-08-30 21:25:51"
1004,8000,1459,0,8000,2,"2016-08-30 21:25:51","2016-08-30 21:25:51"
1005,9900,1657,1657,11557,1,"2016-08-30 21:25:51","2016-08-30 21:25:51"
1006,5000,1338,1338,6338,1,"2016-08-30 21:25:51","2016-08-30 21:25:51"
1007,8000,1425,1425,9425,1,"2016-08-30 21:25:51","2016-08-30 21:25:51"
1008,9900,1594,1594,11494,1,"2016-08-30 21:25:51","2016-08-30 21:25:51"
1009,4000,1218,1218,5218,1,"2016-08-30 21:25:51","2016-08-30 21:25:51"
1010,8900,1638,0,8900,2,"2016-08-30 21:25:51","2016-08-30 21:25:51"
1011,8500,1525,0,8500,2,"2016-08-30 21:25:51","2016-08-30 21:25:51"
1012,8000,1500,1500,9500,2,"2016-08-30 21:25:51","2016-08-30 21:25:51"
1013,9000,1494,1494,10494,1,"2016-08-30 21:25:51","2016-08-30 21:25:51"
1014,5000,1257,1257,6257,2,"2016-08-30 21:25:51","2016-08-30 21:25:51"
1015,8000,1449,0,8000,2,"2016-08-30 21:25:51","2016-08-30 21:25:51"
1016,8900,1510,0,8900,2,"2016-08-30 21:25:51","2016-08-30 21:25:51"
1017,9500,1505,1505,11005,1,"2016-08-30 21:25:51","2016-08-30 21:25:51"
1018,7000,1372,1372,8372,2,"2016-08-30 21:25:51","2016-08-30 21:25:51"
1019,8000,1430,1430,9430,1,"2016-08-30 21:25:51","2016-08-30 21:25:51"
1020,5000,1369,1369,6369,1,"2016-08-30 21:25:51","2016-08-30 21:25:51"
1021,8000,1596,1596,9596,1,"2016-08-30 21:25:51","2016-08-30 21:25:51"
1022,5000,1271,1271,6271,1,"2016-08-30 21:25:51","2016-08-30 21:25:51"
1023,7000,1426,1426,8426,2,"2016-08-30 21:25:51","2016-08-30 21:25:51"
1024,4000,1361,1361,5361,1,"2016-08-30 21:25:51","2016-08-30 21:25:51"
1025,5000,1349,1349,6349,1,"2016-08-30 21:25:51","2016-08-30 21:25:51"
1026,9900,1507,1507,11407,2,"2016-08-30 21:25:51","2016-08-30 21:25:51"
1027,9500,1604,1604,11104,1,"2016-08-30 21:25:51","2016-08-30 21:25:51"
1028,8000,1503,1503,9503,2,"2016-08-30 21:25:51","2016-08-30 21:25:51"
1029,5000,1296,1296,6296,1,"2016-08-30 21:25:51","2016-08-30 21:25:51"
1030,8000,1490,1490,9490,2,"2016-08-30 21:25:51","2016-08-30 21:25:51"
1031,8500,1503,1503,10003,1,"2016-08-30 21:25:51","2016-08-30 21:25:51"
1032,8000,1537,0,8000,2,"2016-08-30 21:25:51","2016-08-30 21:25:51"
1033,4000,1263,1263,5263,1,"2016-08-30 21:25:51","2016-08-30 21:25:51"
1034,7000,1401,1401,8401,1,"2016-08-30 21:25:51","2016-08-30 21:25:51"
1035,6000,1441,1441,7441,1,"2016-08-30 21:25:51","2016-08-30 21:25:51"
1036,9900,1551,1551,11451,1,"2016-08-30 21:25:51","2016-08-30 21:25:51"
1037,8500,1425,1425,9925,1,"2016-08-30 21:25:51","2016-08-30 21:25:51"
1038,6000,1441,1441,7441,2,"2016-08-30 21:25:51","2016-08-30 21:25:51"
1039,8000,1483,1483,9483,2,"2016-08-30 21:25:51","2016-08-30 21:25:51"
1040,9500,1665,1665,11165,1,"2016-08-30 21:25:51","2016-08-30 21:25:51"
1041,9900,1671,1671,11571,1,"2016-08-30 21:25:51","2016-08-30 21:25:51"
1042,7000,1484,1484,8484,1,"2016-08-30 21:25:51","2016-08-30 21:25:51"
1043,8500,1511,0,8500,2,"2016-08-30 21:25:51","2016-08-30 21:25:51"
1044,9000,1608,1608,10608,1,"2016-08-30 21:25:51","2016-08-30 21:25:51"
1045,8000,1587,0,8000,2,"2016-08-30 21:25:51","2016-08-30 21:25:51"
1046,8000,1560,1560,9560,2,"2016-08-30 21:25:51","2016-08-30 21:25:51"
1047,8000,1425,0,8000,2,"2016-08-30 21:25:51","2016-08-30 21:25:51"
1048,9900,1523,1523,11423,1,"2016-08-30 21:25:51","2016-08-30 21:25:51"
1049,9900,1641,1641,11541,1,"2016-08-30 21:25:51","2016-08-30 21:25:51"
1050,5000,1389,1389,6389,2,"2016-08-30 21:25:51","2016-08-30 21:25:51"
1051,8500,1495,1495,9995,1,"2016-08-30 21:25:51","2016-08-30 21:25:51"
1052,8000,1509,1509,9509,1,"2016-08-30 21:25:51","2016-08-30 21:25:51"
1053,8500,1597,1597,10097,1,"2016-08-30 21:25:51","2016-08-30 21:25:51"
1054,4000,1380,1380,5380,2,"2016-08-30 21:25:51","2016-08-30 21:25:51"
1055,8000,1430,1430,9430,2,"2016-08-30 21:25:51","2016-08-30 21:25:51"
1056,4000,1301,1301,5301,1,"2016-08-30 21:25:51","2016-08-30 21:25:51"
1057,8000,1464,1464,9464,1,"2016-08-30 21:25:51","2016-08-30 21:25:51"
1058,7000,1391,1391,8391,1,"2016-08-30 21:25:51","2016-08-30 21:25:51"
1059,4000,1240,1240,5240,1,"2016-08-30 21:25:51","2016-08-30 21:25:51"
1060,7000,1439,1439,8439,1,"2016-08-30 21:25:51","2016-08-30 21:25:51"
1061,4000,1229,1229,5229,1,"2016-08-30 21:25:51","2016-08-30 21:25:51"
1062,8000,1501,0,8000,2,"2016-08-30 21:25:51","2016-08-30 21:25:51"
1063,8000,1484,1484,9484,2,"2016-08-30 21:25:51","2016-08-30 21:25:51"
1064,8000,1402,0,8000,2,"2016-08-30 21:25:51","2016-08-30 21:25:51"
1065,8900,1571,1571,10471,1,"2016-08-30 21:25:51","2016-08-30 21:25:51"
1066,8000,1595,0,8000,2,"2016-08-30 21:25:51","2016-08-30 21:25:51"
1067,8000,1407,1407,9407,1,"2016-08-30 21:25:51","2016-08-30 21:25:51"
1068,8000,1562,0,8000,2,"2016-08-30 21:25:51","2016-08-30 21:25:51"
1069,9900,1591,1591,11491,1,"2016-08-30 21:25:51","2016-08-30 21:25:51"
1070,9900,1645,1645,11545,1,"2016-08-30 21:25:51","2016-08-30 21:25:51"
1071,8500,1469,0,8500,2,"2016-08-30 21:25:51","2016-08-30 21:25:51"
1072,4000,1214,1214,5214,1,"2016-08-30 21:25:51","2016-08-30 21:25:51"
1073,9000,1529,1529,10529,1,"2016-08-30 21:25:51","2016-08-30 21:25:51"
1074,8500,1469,1469,9969,1,"2016-08-30 21:25:51","2016-08-30 21:25:51"
1075,9500,1662,1662,11162,1,"2016-08-30 21:25:51","2016-08-30 21:25:51"
1076,9000,1553,1553,10553,1,"2016-08-30 21:25:51","2016-08-30 21:25:51"
1077,8500,1473,0,8500,2,"2016-08-30 21:25:51","2016-08-30 21:25:51"
1078,4000,1385,1385,5385,1,"2016-08-30 21:25:51","2016-08-30 21:25:51"
1079,8900,1608,1608,10508,1,"2016-08-30 21:25:51","2016-08-30 21:25:51"
1080,9500,1637,1637,11137,1,"2016-08-30 21:25:51","2016-08-30 21:25:51"
1081,8500,1563,0,8500,2,"2016-08-30 21:25:51","2016-08-30 21:25:51"
1082,8000,1530,0,8000,2,"2016-08-30 21:25:51","2016-08-30 21:25:51"
1083,7000,1384,1384,8384,1,"2016-08-30 21:25:51","2016-08-30 21:25:51"
1084,7000,1491,1491,8491,1,"2016-08-30 21:25:51","2016-08-30 21:25:51"
1085,8000,1556,1556,9556,1,"2016-08-30 21:25:51","2016-08-30 21:25:51"
1086,8500,1493,0,8500,2,"2016-08-30 21:25:51","2016-08-30 21:25:51"
1087,8500,1606,0,8500,2,"2016-08-30 21:25:51","2016-08-30 21:25:51"
1088,8500,1478,0,8500,2,"2016-08-30 21:25:51","2016-08-30 21:25:51"
1089,5000,1426,1426,6426,1,"2016-08-30 21:25:52","2016-08-30 21:25:52"
1090,4000,1315,1315,5315,1,"2016-08-30 21:25:52","2016-08-30 21:25:52"
1091,4000,1250,1250,5250,1,"2016-08-30 21:25:52","2016-08-30 21:25:52"
1092,4000,1320,1320,5320,1,"2016-08-30 21:25:52","2016-08-30 21:25:52"
1093,8500,1464,1464,9964,1,"2016-08-30 21:25:52","2016-08-30 21:25:52"
1094,9500,1653,1653,11153,1,"2016-08-30 21:25:52","2016-08-30 21:25:52"
1095,5000,1388,1388,6388,1,"2016-08-30 21:25:52","2016-08-30 21:25:52"
1096,8000,1463,0,8000,2,"2016-08-30 21:25:52","2016-08-30 21:25:52"
1097,8500,1555,0,8500,2,"2016-08-30 21:25:52","2016-08-30 21:25:52"
1098,8500,1499,1499,9999,1,"2016-08-30 21:25:52","2016-08-30 21:25:52"
1099,8000,1517,0,8000,2,"2016-08-30 21:25:52","2016-08-30 21:25:52"
1100,8000,1506,0,8000,2,"2016-08-30 21:25:52","2016-08-30 21:25:52"
1101,7000,1525,1525,8525,1,"2016-08-30 21:25:52","2016-08-30 21:25:52"
1102,8500,1521,0,8500,2,"2016-08-30 21:25:52","2016-08-30 21:25:52"
1103,8000,1458,0,8000,2,"2016-08-30 21:25:52","2016-08-30 21:25:52"
1104,8500,1527,0,8500,2,"2016-08-30 21:25:52","2016-08-30 21:25:52"
1105,8500,1619,1619,10119,1,"2016-08-30 21:25:52","2016-08-30 21:25:52"
1106,6000,1359,1359,7359,2,"2016-08-30 21:25:52","2016-08-30 21:25:52"
1107,6000,1349,1349,7349,1,"2016-08-30 21:25:52","2016-08-30 21:25:52"
1108,8000,1440,1440,9440,1,"2016-08-30 21:25:52","2016-08-30 21:25:52"
1109,5000,1314,1314,6314,2,"2016-08-30 21:25:52","2016-08-30 21:25:52"
1110,8000,1553,0,8000,2,"2016-08-30 21:25:52","2016-08-30 21:25:52"
1111,9500,1537,0,9500,2,"2016-08-30 21:25:52","2016-08-30 21:25:52"
1112,8500,1460,0,8500,2,"2016-08-30 21:25:52","2016-08-30 21:25:52"
1113,6000,1372,1372,7372,1,"2016-08-30 21:25:52","2016-08-30 21:25:52"
1114,4000,1304,1304,5304,1,"2016-08-30 21:25:52","2016-08-30 21:25:52"
1115,9900,1601,0,9900,2,"2016-08-30 21:25:52","2016-08-30 21:25:52"
1116,8000,1446,0,8000,2,"2016-08-30 21:25:52","2016-08-30 21:25:52"
1117,8000,1453,1453,9453,1,"2016-08-30 21:25:52","2016-08-30 21:25:52"
1118,8500,1567,0,8500,2,"2016-08-30 21:25:52","2016-08-30 21:25:52"
1119,5000,1304,1304,6304,1,"2016-08-30 21:25:52","2016-08-30 21:25:52"
1120,8000,1417,0,8000,2,"2016-08-30 21:25:52","2016-08-30 21:25:52"
1121,8000,1568,1568,9568,1,"2016-08-30 21:25:52","2016-08-30 21:25:52"
1122,8900,1476,1476,10376,2,"2016-08-30 21:25:52","2016-08-30 21:25:52"
1123,4000,1201,1201,5201,2,"2016-08-30 21:25:52","2016-08-30 21:25:52"
1124,7000,1432,1432,8432,2,"2016-08-30 21:25:52","2016-08-30 21:25:52"
1125,8900,1517,1517,10417,1,"2016-08-30 21:25:52","2016-08-30 21:25:52"
1126,8000,1446,0,8000,2,"2016-08-30 21:25:52","2016-08-30 21:25:52"
1127,8900,1521,1521,10421,2,"2016-08-30 21:25:52","2016-08-30 21:25:52"
1128,9000,1543,0,9000,2,"2016-08-30 21:25:52","2016-08-30 21:25:52"
1129,8900,1497,1497,10397,1,"2016-08-30 21:25:52","2016-08-30 21:25:52"
1130,4000,1286,1286,5286,2,"2016-08-30 21:25:52","2016-08-30 21:25:52"
1131,8000,1426,1426,9426,1,"2016-08-30 21:25:52","2016-08-30 21:25:52"
1132,8000,1469,1469,9469,1,"2016-08-30 21:25:52","2016-08-30 21:25:52"
1133,8000,1583,0,8000,2,"2016-08-30 21:25:52","2016-08-30 21:25:52"
1134,8000,1455,1455,9455,1,"2016-08-30 21:25:52","2016-08-30 21:25:52"
1135,7000,1535,1535,8535,1,"2016-08-30 21:25:52","2016-08-30 21:25:52"
1136,8000,1416,1416,9416,2,"2016-08-30 21:25:52","2016-08-30 21:25:52"
1137,8500,1519,0,8500,2,"2016-08-30 21:25:52","2016-08-30 21:25:52"
1138,8500,1515,0,8500,2,"2016-08-30 21:25:52","2016-08-30 21:25:52"
1139,8000,1462,1462,9462,1,"2016-08-30 21:25:52","2016-08-30 21:25:52"
1140,5000,1303,1303,6303,1,"2016-08-30 21:25:52","2016-08-30 21:25:52"
1141,9500,1519,0,9500,2,"2016-08-30 21:25:52","2016-08-30 21:25:52"
1142,4000,1285,1285,5285,2,"2016-08-30 21:25:52","2016-08-30 21:25:52"
1143,8000,1536,1536,9536,2,"2016-08-30 21:25:52","2016-08-30 21:25:52"
1144,8000,1431,0,8000,2,"2016-08-30 21:25:52","2016-08-30 21:25:52"
1145,8900,1476,1476,10376,1,"2016-08-30 21:25:52","2016-08-30 21:25:52"
1146,5000,1255,1255,6255,2,"2016-08-30 21:25:52","2016-08-30 21:25:52"
1147,9500,1609,1609,11109,1,"2016-08-30 21:25:52","2016-08-30 21:25:52"
1148,6000,1359,1359,7359,1,"2016-08-30 21:25:52","2016-08-30 21:25:52"
1149,8500,1525,1525,10025,1,"2016-08-30 21:25:52","2016-08-30 21:25:52"
1150,9900,1531,1531,11431,1,"2016-08-30 21:25:52","2016-08-30 21:25:52"
1151,8500,1607,1607,10107,1,"2016-08-30 21:25:52","2016-08-30 21:25:52"
1152,8900,1447,0,8900,2,"2016-08-30 21:25:52","2016-08-30 21:25:52"
1153,5000,1329,1329,6329,1,"2016-08-30 21:25:52","2016-08-30 21:25:52"
1154,8900,1627,1627,10527,1,"2016-08-30 21:25:52","2016-08-30 21:25:52"
1155,8000,1520,0,8000,2,"2016-08-30 21:25:52","2016-08-30 21:25:52"
1156,8000,1502,0,8000,2,"2016-08-30 21:25:52","2016-08-30 21:25:52"
1157,8000,1431,0,8000,2,"2016-08-30 21:25:52","2016-08-30 21:25:52"
1158,5000,1391,1391,6391,2,"2016-08-30 21:25:52","2016-08-30 21:25:52"
1159,8000,1464,0,8000,2,"2016-08-30 21:25:52","2016-08-30 21:25:52"
1160,4000,1337,1337,5337,1,"2016-08-30 21:25:52","2016-08-30 21:25:52"
1161,4000,1203,1203,5203,1,"2016-08-30 21:25:52","2016-08-30 21:25:52"
1162,8500,1452,1452,9952,1,"2016-08-30 21:25:52","2016-08-30 21:25:52"
1163,8000,1509,1509,9509,1,"2016-08-30 21:25:52","2016-08-30 21:25:52"
1164,8900,1576,0,8900,2,"2016-08-30 21:25:52","2016-08-30 21:25:52"
1165,8000,1571,0,8000,2,"2016-08-30 21:25:52","2016-08-30 21:25:52"
1166,9900,1689,1689,11589,1,"2016-08-30 21:25:52","2016-08-30 21:25:52"
1167,4000,1333,1333,5333,2,"2016-08-30 21:25:52","2016-08-30 21:25:52"
1168,9900,1543,1543,11443,1,"2016-08-30 21:25:52","2016-08-30 21:25:52"
1169,9900,1616,0,9900,2,"2016-08-30 21:25:52","2016-08-30 21:25:52"
1170,8500,1524,0,8500,2,"2016-08-30 21:25:52","2016-08-30 21:25:52"
1171,8500,1439,1439,9939,2,"2016-08-30 21:25:52","2016-08-30 21:25:52"
1172,8000,1594,1594,9594,1,"2016-08-30 21:25:52","2016-08-30 21:25:52"
1173,8500,1592,1592,10092,2,"2016-08-30 21:25:52","2016-08-30 21:25:52"
1174,8500,1552,1552,10052,1,"2016-08-30 21:25:52","2016-08-30 21:25:52"
1175,8000,1417,1417,9417,2,"2016-08-30 21:25:52","2016-08-30 21:25:52"
1176,8000,1511,0,8000,2,"2016-08-30 21:25:52","2016-08-30 21:25:52"
1177,7000,1419,1419,8419,2,"2016-08-30 21:25:52","2016-08-30 21:25:52"
1178,5000,1343,1343,6343,1,"2016-08-30 21:25:52","2016-08-30 21:25:52"
1179,8000,1489,1489,9489,1,"2016-08-30 21:25:52","2016-08-30 21:25:52"
1180,8500,1596,0,8500,2,"2016-08-30 21:25:52","2016-08-30 21:25:52"
1181,9500,1521,1521,11021,1,"2016-08-30 21:25:52","2016-08-30 21:25:52"
1182,9000,1503,1503,10503,1,"2016-08-30 21:25:52","2016-08-30 21:25:52"
1183,8900,1451,1451,10351,1,"2016-08-30 21:25:52","2016-08-30 21:25:52"
1184,8500,1548,1548,10048,2,"2016-08-30 21:25:52","2016-08-30 21:25:52"
1185,8000,1568,1568,9568,1,"2016-08-30 21:25:52","2016-08-30 21:25:52"
1186,8500,1525,1525,10025,2,"2016-08-30 21:25:52","2016-08-30 21:25:52"
1187,6000,1316,1316,7316,1,"2016-08-30 21:25:52","2016-08-30 21:25:52"
1188,8500,1426,1426,9926,2,"2016-08-30 21:25:52","2016-08-30 21:25:52"
1189,9900,1587,1587,11487,1,"2016-08-30 21:25:52","2016-08-30 21:25:52"
1190,7000,1456,1456,8456,1,"2016-08-30 21:25:52","2016-08-30 21:25:52"
1191,9500,1595,1595,11095,1,"2016-08-30 21:25:52","2016-08-30 21:25:52"
1192,8000,1401,1401,9401,1,"2016-08-30 21:25:52","2016-08-30 21:25:52"
1193,4000,1274,1274,5274,1,"2016-08-30 21:25:52","2016-08-30 21:25:52"
1194,8000,1463,0,8000,2,"2016-08-30 21:25:52","2016-08-30 21:25:52"
1195,8000,1446,1446,9446,2,"2016-08-30 21:25:52","2016-08-30 21:25:52"
1196,6000,1381,1381,7381,1,"2016-08-30 21:25:52","2016-08-30 21:25:52"
1197,4000,1334,1334,5334,1,"2016-08-30 21:25:52","2016-08-30 21:25:52"
1198,9000,1635,1635,10635,1,"2016-08-30 21:25:52","2016-08-30 21:25:52"
1199,8900,1470,1470,10370,2,"2016-08-30 21:25:52","2016-08-30 21:25:52"
1200,4000,1241,1241,5241,1,"2016-08-30 21:25:52","2016-08-30 21:25:52"
1201,8000,1480,1480,9480,1,"2016-08-30 21:25:52","2016-08-30 21:25:52"
1202,8500,1602,1602,10102,1,"2016-08-30 21:25:52","2016-08-30 21:25:52"
1203,8900,1452,0,8900,2,"2016-08-30 21:25:52","2016-08-30 21:25:52"
1204,8000,1581,1581,9581,1,"2016-08-30 21:25:52","2016-08-30 21:25:52"
1205,8500,1507,0,8500,2,"2016-08-30 21:25:52","2016-08-30 21:25:52"
1206,8000,1443,0,8000,2,"2016-08-30 21:25:52","2016-08-30 21:25:52"
1207,5000,1394,1394,6394,1,"2016-08-30 21:25:52","2016-08-30 21:25:52"
1208,8500,1470,0,8500,2,"2016-08-30 21:25:52","2016-08-30 21:25:52"
1209,8000,1450,1450,9450,2,"2016-08-30 21:25:52","2016-08-30 21:25:52"
1210,8900,1580,0,8900,2,"2016-08-30 21:25:52","2016-08-30 21:25:52"
1211,5000,1390,1390,6390,2,"2016-08-30 21:25:52","2016-08-30 21:25:52"
1212,9900,1580,1580,11480,1,"2016-08-30 21:25:52","2016-08-30 21:25:52"
1213,8000,1563,1563,9563,1,"2016-08-30 21:25:52","2016-08-30 21:25:52"
1214,8000,1427,0,8000,2,"2016-08-30 21:25:52","2016-08-30 21:25:52"
1215,8000,1591,0,8000,2,"2016-08-30 21:25:52","2016-08-30 21:25:52"
1216,9000,1512,1512,10512,1,"2016-08-30 21:25:52","2016-08-30 21:25:52"
1217,8900,1554,0,8900,2,"2016-08-30 21:25:52","2016-08-30 21:25:52"
1218,8000,1412,0,8000,2,"2016-08-30 21:25:52","2016-08-30 21:25:52"
1219,8500,1458,1458,9958,2,"2016-08-30 21:25:52","2016-08-30 21:25:52"
1220,9900,1575,0,9900,2,"2016-08-30 21:25:52","2016-08-30 21:25:52"
1221,8000,1505,1505,9505,2,"2016-08-30 21:25:52","2016-08-30 21:25:52"
1222,8900,1556,0,8900,2,"2016-08-30 21:25:52","2016-08-30 21:25:52"
1223,5000,1332,1332,6332,1,"2016-08-30 21:25:52","2016-08-30 21:25:52"
1224,8900,1509,0,8900,2,"2016-08-30 21:25:52","2016-08-30 21:25:52"
1225,8900,1544,0,8900,2,"2016-08-30 21:25:52","2016-08-30 21:25:52"
1226,9900,1617,1617,11517,1,"2016-08-30 21:25:52","2016-08-30 21:25:52"
1227,6000,1435,1435,7435,1,"2016-08-30 21:25:52","2016-08-30 21:25:52"
1228,9000,1496,1496,10496,1,"2016-08-30 21:25:52","2016-08-30 21:25:52"
1229,8000,1490,1490,9490,2,"2016-08-30 21:25:52","2016-08-30 21:25:52"
1230,8000,1547,1547,9547,2,"2016-08-30 21:25:52","2016-08-30 21:25:52"
1231,8000,1439,0,8000,2,"2016-08-30 21:25:52","2016-08-30 21:25:52"
1232,9900,1683,1683,11583,1,"2016-08-30 21:25:52","2016-08-30 21:25:52"
1233,8500,1436,0,8500,2,"2016-08-30 21:25:52","2016-08-30 21:25:52"
1234,7000,1396,1396,8396,1,"2016-08-30 21:25:52","2016-08-30 21:25:52"
1235,5000,1330,1330,6330,2,"2016-08-30 21:25:52","2016-08-30 21:25:52"
1236,8500,1587,0,8500,2,"2016-08-30 21:25:52","2016-08-30 21:25:52"
1237,8500,1536,1536,10036,1,"2016-08-30 21:25:52","2016-08-30 21:25:52"
1238,9000,1547,1547,10547,1,"2016-08-30 21:25:52","2016-08-30 21:25:52"
1239,9500,1656,1656,11156,1,"2016-08-30 21:25:52","2016-08-30 21:25:52"
1240,9000,1628,1628,10628,1,"2016-08-30 21:25:52","2016-08-30 21:25:52"
1241,7000,1536,1536,8536,2,"2016-08-30 21:25:52","2016-08-30 21:25:52"
1242,8900,1522,0,8900,2,"2016-08-30 21:25:52","2016-08-30 21:25:52"
1243,9500,1650,0,9500,2,"2016-08-30 21:25:52","2016-08-30 21:25:52"
1244,8000,1584,0,8000,2,"2016-08-30 21:25:52","2016-08-30 21:25:52"
1245,8000,1542,1542,9542,1,"2016-08-30 21:25:52","2016-08-30 21:25:52"
1246,8000,1492,1492,9492,2,"2016-08-30 21:25:52","2016-08-30 21:25:52"
1247,5000,1440,1440,6440,1,"2016-08-30 21:25:52","2016-08-30 21:25:52"
1248,4000,1237,1237,5237,1,"2016-08-30 21:25:52","2016-08-30 21:25:52"
1249,5000,1267,1267,6267,2,"2016-08-30 21:25:52","2016-08-30 21:25:52"
1250,5000,1379,1379,6379,1,"2016-08-30 21:25:52","2016-08-30 21:25:52"
1251,9900,1624,0,9900,2,"2016-08-30 21:25:52","2016-08-30 21:25:52"
1252,8000,1490,1490,9490,1,"2016-08-30 21:25:52","2016-08-30 21:25:52"
1253,8000,1431,0,8000,2,"2016-08-30 21:25:52","2016-08-30 21:25:52"
1254,8000,1524,1524,9524,2,"2016-08-30 21:25:52","2016-08-30 21:25:52"
1255,8900,1485,0,8900,2,"2016-08-30 21:25:52","2016-08-30 21:25:52"
1256,4000,1392,1392,5392,1,"2016-08-30 21:25:52","2016-08-30 21:25:52"
1257,7000,1394,1394,8394,1,"2016-08-30 21:25:52","2016-08-30 21:25:52"
1258,8000,1478,0,8000,2,"2016-08-30 21:25:52","2016-08-30 21:25:52"
1259,9500,1533,0,9500,2,"2016-08-30 21:25:52","2016-08-30 21:25:52"
1260,8000,1557,0,8000,2,"2016-08-30 21:25:52","2016-08-30 21:25:52"
1261,8900,1503,1503,10403,1,"2016-08-30 21:25:52","2016-08-30 21:25:52"
1262,8900,1558,0,8900,2,"2016-08-30 21:25:52","2016-08-30 21:25:52"
1263,8500,1452,1452,9952,1,"2016-08-30 21:25:52","2016-08-30 21:25:52"
1264,9500,1482,1482,10982,1,"2016-08-30 21:25:52","2016-08-30 21:25:52"
1265,9900,1517,1517,11417,1,"2016-08-30 21:25:52","2016-08-30 21:25:52"
1266,5000,1370,1370,6370,1,"2016-08-30 21:25:52","2016-08-30 21:25:52"
1267,8900,1491,1491,10391,2,"2016-08-30 21:25:52","2016-08-30 21:25:52"
1268,9900,1621,0,9900,2,"2016-08-30 21:25:52","2016-08-30 21:25:52"
1269,5000,1321,1321,6321,1,"2016-08-30 21:25:52","2016-08-30 21:25:52"
1270,9000,1484,1484,10484,1,"2016-08-30 21:25:52","2016-08-30 21:25:52"
1271,9500,1651,0,9500,2,"2016-08-30 21:25:52","2016-08-30 21:25:52"
1272,9500,1614,0,9500,2,"2016-08-30 21:25:52","2016-08-30 21:25:52"
1273,6000,1493,1493,7493,1,"2016-08-30 21:25:52","2016-08-30 21:25:52"
1274,4000,1289,1289,5289,1,"2016-08-30 21:25:52","2016-08-30 21:25:52"
1275,9900,1685,1685,11585,1,"2016-08-30 21:25:52","2016-08-30 21:25:52"
1276,8000,1447,0,8000,2,"2016-08-30 21:25:52","2016-08-30 21:25:52"
1277,4000,1229,1229,5229,2,"2016-08-30 21:25:52","2016-08-30 21:25:52"
1278,5000,1269,1269,6269,1,"2016-08-30 21:25:52","2016-08-30 21:25:52"
1279,7000,1483,1483,8483,1,"2016-08-30 21:25:52","2016-08-30 21:25:52"
1280,5000,1279,1279,6279,2,"2016-08-30 21:25:52","2016-08-30 21:25:52"
1281,8500,1620,1620,10120,1,"2016-08-30 21:25:52","2016-08-30 21:25:52"
1282,8900,1545,1545,10445,2,"2016-08-30 21:25:52","2016-08-30 21:25:52"
1283,8500,1525,0,8500,2,"2016-08-30 21:25:52","2016-08-30 21:25:52"
1284,4000,1297,1297,5297,1,"2016-08-30 21:25:52","2016-08-30 21:25:52"
1285,8000,1546,0,8000,2,"2016-08-30 21:25:52","2016-08-30 21:25:52"
1286,9000,1527,1527,10527,1,"2016-08-30 21:25:52","2016-08-30 21:25:52"
1287,8000,1491,0,8000,2,"2016-08-30 21:25:52","2016-08-30 21:25:52"
1288,8000,1429,0,8000,2,"2016-08-30 21:25:52","2016-08-30 21:25:52"
1289,8900,1626,1626,10526,1,"2016-08-30 21:25:52","2016-08-30 21:25:52"
1290,4000,1331,1331,5331,2,"2016-08-30 21:25:52","2016-08-30 21:25:52"
1291,8500,1444,1444,9944,1,"2016-08-30 21:25:52","2016-08-30 21:25:52"
1292,5000,1264,1264,6264,1,"2016-08-30 21:25:52","2016-08-30 21:25:52"
1293,9900,1659,1659,11559,1,"2016-08-30 21:25:52","2016-08-30 21:25:52"
1294,8900,1544,0,8900,2,"2016-08-30 21:25:52","2016-08-30 21:25:52"
1295,8000,1465,0,8000,2,"2016-08-30 21:25:52","2016-08-30 21:25:52"
1296,9900,1648,0,9900,2,"2016-08-30 21:25:52","2016-08-30 21:25:52"
1297,8000,1519,0,8000,2,"2016-08-30 21:25:52","2016-08-30 21:25:52"
1298,9900,1575,1575,11475,1,"2016-08-30 21:25:52","2016-08-30 21:25:52"
1299,9000,1450,0,9000,2,"2016-08-30 21:25:52","2016-08-30 21:25:52"
1300,8000,1427,0,8000,2,"2016-08-30 21:25:52","2016-08-30 21:25:52"
1301,4000,1395,1395,5395,1,"2016-08-30 21:25:52","2016-08-30 21:25:52"
1302,8900,1642,0,8900,2,"2016-08-30 21:25:52","2016-08-30 21:25:52"
1303,8000,1587,0,8000,2,"2016-08-30 21:25:52","2016-08-30 21:25:52"
1304,7000,1352,1352,8352,1,"2016-08-30 21:25:52","2016-08-30 21:25:52"
1305,8000,1433,1433,9433,2,"2016-08-30 21:25:52","2016-08-30 21:25:52"
1306,9500,1663,1663,11163,1,"2016-08-30 21:25:52","2016-08-30 21:25:52"
1307,4000,1307,1307,5307,1,"2016-08-30 21:25:52","2016-08-30 21:25:52"
1308,4000,1291,1291,5291,1,"2016-08-30 21:25:52","2016-08-30 21:25:52"
1309,6000,1427,1427,7427,1,"2016-08-30 21:25:52","2016-08-30 21:25:52"
1310,4000,1279,1279,5279,1,"2016-08-30 21:25:52","2016-08-30 21:25:52"
1311,8000,1497,0,8000,2,"2016-08-30 21:25:52","2016-08-30 21:25:52"
1312,9500,1658,1658,11158,1,"2016-08-30 21:25:52","2016-08-30 21:25:52"
1313,9000,1648,1648,10648,1,"2016-08-30 21:25:52","2016-08-30 21:25:52"
1314,5000,1281,1281,6281,1,"2016-08-30 21:25:52","2016-08-30 21:25:52"
1315,8000,1468,1468,9468,1,"2016-08-30 21:25:52","2016-08-30 21:25:52"
1316,8000,1480,0,8000,2,"2016-08-30 21:25:52","2016-08-30 21:25:52"
1317,9500,1492,0,9500,2,"2016-08-30 21:25:52","2016-08-30 21:25:52"
1318,8900,1592,1592,10492,2,"2016-08-30 21:25:52","2016-08-30 21:25:52"
1319,8900,1461,1461,10361,1,"2016-08-30 21:25:52","2016-08-30 21:25:52"
1320,5000,1309,1309,6309,1,"2016-08-30 21:25:52","2016-08-30 21:25:52"
1321,9500,1536,1536,11036,1,"2016-08-30 21:25:52","2016-08-30 21:25:52"
1322,4000,1250,1250,5250,1,"2016-08-30 21:25:52","2016-08-30 21:25:52"
1323,9900,1658,1658,11558,1,"2016-08-30 21:25:52","2016-08-30 21:25:52"
1324,4000,1202,1202,5202,1,"2016-08-30 21:25:52","2016-08-30 21:25:52"
1325,9500,1632,0,9500,2,"2016-08-30 21:25:52","2016-08-30 21:25:52"
1326,8900,1612,0,8900,2,"2016-08-30 21:25:52","2016-08-30 21:25:52"
1327,4000,1220,1220,5220,1,"2016-08-30 21:25:52","2016-08-30 21:25:52"
1328,5000,1383,1383,6383,2,"2016-08-30 21:25:52","2016-08-30 21:25:52"
1329,8000,1451,0,8000,2,"2016-08-30 21:25:52","2016-08-30 21:25:52"
1330,4000,1219,1219,5219,1,"2016-08-30 21:25:52","2016-08-30 21:25:52"
1331,8000,1556,1556,9556,1,"2016-08-30 21:25:52","2016-08-30 21:25:52"
1332,8000,1557,0,8000,2,"2016-08-30 21:25:52","2016-08-30 21:25:52"
1333,5000,1285,1285,6285,1,"2016-08-30 21:25:52","2016-08-30 21:25:52"
1334,8900,1546,0,8900,2,"2016-08-30 21:25:52","2016-08-30 21:25:52"
1335,4000,1255,1255,5255,1,"2016-08-30 21:25:52","2016-08-30 21:25:52"
1336,8900,1533,0,8900,2,"2016-08-30 21:25:52","2016-08-30 21:25:52"
1337,8500,1552,1552,10052,1,"2016-08-30 21:25:52","2016-08-30 21:25:52"
1338,9900,1522,1522,11422,1,"2016-08-30 21:25:52","2016-08-30 21:25:52"
1339,8500,1558,1558,10058,1,"2016-08-30 21:25:52","2016-08-30 21:25:52"
1340,8900,1586,1586,10486,2,"2016-08-30 21:25:52","2016-08-30 21:25:52"
1341,4000,1366,1366,5366,1,"2016-08-30 21:25:52","2016-08-30 21:25:52"
1342,4000,1384,1384,5384,1,"2016-08-30 21:25:52","2016-08-30 21:25:52"
1343,4000,1221,1221,5221,1,"2016-08-30 21:25:52","2016-08-30 21:25:52"
1344,8000,1465,0,8000,2,"2016-08-30 21:25:52","2016-08-30 21:25:52"
1345,7000,1384,1384,8384,2,"2016-08-30 21:25:52","2016-08-30 21:25:52"
1346,8000,1403,0,8000,2,"2016-08-30 21:25:52","2016-08-30 21:25:52"
1347,9000,1558,1558,10558,1,"2016-08-30 21:25:52","2016-08-30 21:25:52"
1348,9900,1688,1688,11588,1,"2016-08-30 21:25:52","2016-08-30 21:25:52"
1349,8900,1451,1451,10351,1,"2016-08-30 21:25:52","2016-08-30 21:25:52"
1350,8000,1416,0,8000,2,"2016-08-30 21:25:52","2016-08-30 21:25:52"
1351,7000,1488,1488,8488,1,"2016-08-30 21:25:52","2016-08-30 21:25:52"
1352,8500,1593,0,8500,2,"2016-08-30 21:25:52","2016-08-30 21:25:52"
1353,8500,1583,1583,10083,1,"2016-08-30 21:25:52","2016-08-30 21:25:52"
1354,8000,1410,0,8000,2,"2016-08-30 21:25:52","2016-08-30 21:25:52"
1355,5000,1390,1390,6390,2,"2016-08-30 21:25:52","2016-08-30 21:25:52"
1356,8000,1528,0,8000,2,"2016-08-30 21:25:52","2016-08-30 21:25:52"
1357,8900,1546,0,8900,2,"2016-08-30 21:25:52","2016-08-30 21:25:52"
1358,9500,1501,1501,11001,1,"2016-08-30 21:25:52","2016-08-30 21:25:52"
1359,7000,1507,1507,8507,1,"2016-08-30 21:25:52","2016-08-30 21:25:52"
1360,8000,1479,1479,9479,2,"2016-08-30 21:25:52","2016-08-30 21:25:52"
1361,9000,1482,1482,10482,1,"2016-08-30 21:25:52","2016-08-30 21:25:52"
1362,5000,1321,1321,6321,1,"2016-08-30 21:25:52","2016-08-30 21:25:52"
1363,8000,1553,0,8000,2,"2016-08-30 21:25:52","2016-08-30 21:25:52"
1364,8000,1496,0,8000,2,"2016-08-30 21:25:52","2016-08-30 21:25:52"
1365,8500,1469,1469,9969,1,"2016-08-30 21:25:52","2016-08-30 21:25:52"
1366,6000,1312,1312,7312,2,"2016-08-30 21:25:52","2016-08-30 21:25:52"
1367,5000,1437,1437,6437,1,"2016-08-30 21:25:52","2016-08-30 21:25:52"
1368,4000,1292,1292,5292,1,"2016-08-30 21:25:52","2016-08-30 21:25:52"
1369,4000,1289,1289,5289,2,"2016-08-30 21:25:52","2016-08-30 21:25:52"
1370,5000,1406,1406,6406,2,"2016-08-30 21:25:52","2016-08-30 21:25:52"
1371,8500,1623,0,8500,2,"2016-08-30 21:25:52","2016-08-30 21:25:52"
1372,8900,1548,0,8900,2,"2016-08-30 21:25:52","2016-08-30 21:25:52"
1373,6000,1396,1396,7396,2,"2016-08-30 21:25:52","2016-08-30 21:25:52"
1374,9900,1506,1506,11406,1,"2016-08-30 21:25:52","2016-08-30 21:25:52"
1375,8500,1567,0,8500,2,"2016-08-30 21:25:52","2016-08-30 21:25:52"
1376,5000,1433,1433,6433,1,"2016-08-30 21:25:52","2016-08-30 21:25:52"
1377,8000,1552,0,8000,2,"2016-08-30 21:25:52","2016-08-30 21:25:52"
1378,6000,1412,1412,7412,1,"2016-08-30 21:25:52","2016-08-30 21:25:52"
1379,8900,1472,1472,10372,2,"2016-08-30 21:25:52","2016-08-30 21:25:52"
1380,8000,1509,0,8000,2,"2016-08-30 21:25:52","2016-08-30 21:25:52"
1381,4000,1200,1200,5200,1,"2016-08-30 21:25:52","2016-08-30 21:25:52"
1382,8500,1617,0,8500,2,"2016-08-30 21:25:52","2016-08-30 21:25:52"
1383,9500,1556,0,9500,2,"2016-08-30 21:25:52","2016-08-30 21:25:52"
1384,7000,1371,1371,8371,2,"2016-08-30 21:25:52","2016-08-30 21:25:52"
1385,8500,1554,1554,10054,1,"2016-08-30 21:25:52","2016-08-30 21:25:52"
1386,7000,1445,1445,8445,2,"2016-08-30 21:25:52","2016-08-30 21:25:52"
1387,8000,1568,0,8000,2,"2016-08-30 21:25:52","2016-08-30 21:25:52"
1388,8900,1523,1523,10423,1,"2016-08-30 21:25:52","2016-08-30 21:25:52"
1389,4000,1271,1271,5271,2,"2016-08-30 21:25:52","2016-08-30 21:25:52"
1390,9000,1630,1630,10630,1,"2016-08-30 21:25:52","2016-08-30 21:25:52"
1391,9500,1608,1608,11108,1,"2016-08-30 21:25:52","2016-08-30 21:25:52"
1392,8000,1456,1456,9456,1,"2016-08-30 21:25:52","2016-08-30 21:25:52"
1393,8000,1491,0,8000,2,"2016-08-30 21:25:52","2016-08-30 21:25:52"
1394,8000,1587,0,8000,2,"2016-08-30 21:25:52","2016-08-30 21:25:52"
1395,4000,1257,1257,5257,2,"2016-08-30 21:25:52","2016-08-30 21:25:52"
1396,9500,1607,1607,11107,1,"2016-08-30 21:25:52","2016-08-30 21:25:52"
1397,5000,1344,1344,6344,1,"2016-08-30 21:25:52","2016-08-30 21:25:52"
1398,8500,1557,0,8500,2,"2016-08-30 21:25:52","2016-08-30 21:25:52"
1399,4000,1230,1230,5230,2,"2016-08-30 21:25:52","2016-08-30 21:25:52"
1400,8900,1629,1629,10529,1,"2016-08-30 21:25:53","2016-08-30 21:25:53"
1401,8900,1492,0,8900,2,"2016-08-30 21:25:53","2016-08-30 21:25:53"
1402,8900,1608,1608,10508,1,"2016-08-30 21:25:53","2016-08-30 21:25:53"
1403,4000,1261,1261,5261,2,"2016-08-30 21:25:53","2016-08-30 21:25:53"
1404,4000,1343,1343,5343,1,"2016-08-30 21:25:53","2016-08-30 21:25:53"
1405,9500,1576,1576,11076,1,"2016-08-30 21:25:53","2016-08-30 21:25:53"
1406,9000,1476,0,9000,2,"2016-08-30 21:25:53","2016-08-30 21:25:53"
1407,9500,1524,1524,11024,1,"2016-08-30 21:25:53","2016-08-30 21:25:53"
1408,7000,1487,1487,8487,1,"2016-08-30 21:25:53","2016-08-30 21:25:53"
1409,9500,1503,1503,11003,1,"2016-08-30 21:25:53","2016-08-30 21:25:53"
1410,5000,1261,1261,6261,1,"2016-08-30 21:25:53","2016-08-30 21:25:53"
1411,9900,1515,1515,11415,1,"2016-08-30 21:25:53","2016-08-30 21:25:53"
1412,8900,1463,0,8900,2,"2016-08-30 21:25:53","2016-08-30 21:25:53"
1413,7000,1376,1376,8376,2,"2016-08-30 21:25:53","2016-08-30 21:25:53"
1414,5000,1401,1401,6401,1,"2016-08-30 21:25:53","2016-08-30 21:25:53"
1415,5000,1313,1313,6313,2,"2016-08-30 21:25:53","2016-08-30 21:25:53"
1416,5000,1388,1388,6388,1,"2016-08-30 21:25:53","2016-08-30 21:25:53"
1417,8500,1547,1547,10047,1,"2016-08-30 21:25:53","2016-08-30 21:25:53"
1418,8500,1528,0,8500,2,"2016-08-30 21:25:53","2016-08-30 21:25:53"
1419,6000,1469,1469,7469,1,"2016-08-30 21:25:53","2016-08-30 21:25:53"
1420,8000,1416,0,8000,2,"2016-08-30 21:25:53","2016-08-30 21:25:53"
1421,5000,1254,1254,6254,1,"2016-08-30 21:25:53","2016-08-30 21:25:53"
1422,9000,1450,0,9000,2,"2016-08-30 21:25:53","2016-08-30 21:25:53"
1423,8000,1455,0,8000,2,"2016-08-30 21:25:53","2016-08-30 21:25:53"
1424,4000,1300,1300,5300,1,"2016-08-30 21:25:53","2016-08-30 21:25:53"
1425,6000,1346,1346,7346,1,"2016-08-30 21:25:53","2016-08-30 21:25:53"
1426,7000,1376,1376,8376,1,"2016-08-30 21:25:53","2016-08-30 21:25:53"
1427,7000,1466,1466,8466,1,"2016-08-30 21:25:53","2016-08-30 21:25:53"
1428,5000,1300,1300,6300,1,"2016-08-30 21:25:53","2016-08-30 21:25:53"
1429,8000,1517,0,8000,2,"2016-08-30 21:25:53","2016-08-30 21:25:53"
1430,8500,1506,0,8500,2,"2016-08-30 21:25:53","2016-08-30 21:25:53"
1431,8000,1572,0,8000,2,"2016-08-30 21:25:53","2016-08-30 21:25:53"
1432,8900,1459,1459,10359,2,"2016-08-30 21:25:53","2016-08-30 21:25:53"
1433,4000,1217,1217,5217,1,"2016-08-30 21:25:53","2016-08-30 21:25:53"
1434,9900,1671,1671,11571,1,"2016-08-30 21:25:53","2016-08-30 21:25:53"
1435,6000,1386,1386,7386,1,"2016-08-30 21:25:53","2016-08-30 21:25:53"
1436,8000,1439,0,8000,2,"2016-08-30 21:25:53","2016-08-30 21:25:53"
1437,9900,1609,0,9900,2,"2016-08-30 21:25:53","2016-08-30 21:25:53"
1438,8500,1614,1614,10114,2,"2016-08-30 21:25:53","2016-08-30 21:25:53"
1439,9900,1635,1635,11535,1,"2016-08-30 21:25:53","2016-08-30 21:25:53"
1440,8000,1549,1549,9549,1,"2016-08-30 21:25:53","2016-08-30 21:25:53"
1441,7000,1488,1488,8488,1,"2016-08-30 21:25:53","2016-08-30 21:25:53"
1442,8000,1506,0,8000,2,"2016-08-30 21:25:53","2016-08-30 21:25:53"
1443,8000,1494,0,8000,2,"2016-08-30 21:25:53","2016-08-30 21:25:53"
1444,8000,1510,0,8000,2,"2016-08-30 21:25:53","2016-08-30 21:25:53"
1445,8500,1519,0,8500,2,"2016-08-30 21:25:53","2016-08-30 21:25:53"
1446,4000,1240,1240,5240,1,"2016-08-30 21:25:53","2016-08-30 21:25:53"
1447,4000,1208,1208,5208,1,"2016-08-30 21:25:53","2016-08-30 21:25:53"
1448,8000,1507,0,8000,2,"2016-08-30 21:25:53","2016-08-30 21:25:53"
1449,7000,1474,1474,8474,1,"2016-08-30 21:25:53","2016-08-30 21:25:53"
1450,8500,1530,1530,10030,1,"2016-08-30 21:25:53","2016-08-30 21:25:53"
1451,5000,1334,1334,6334,1,"2016-08-30 21:25:53","2016-08-30 21:25:53"
1452,9900,1571,0,9900,2,"2016-08-30 21:25:53","2016-08-30 21:25:53"
1453,9000,1616,0,9000,2,"2016-08-30 21:25:53","2016-08-30 21:25:53"
1454,5000,1265,1265,6265,1,"2016-08-30 21:25:53","2016-08-30 21:25:53"
1455,4000,1257,1257,5257,2,"2016-08-30 21:25:53","2016-08-30 21:25:53"
1456,4000,1245,1245,5245,2,"2016-08-30 21:25:53","2016-08-30 21:25:53"
1457,9900,1629,1629,11529,1,"2016-08-30 21:25:53","2016-08-30 21:25:53"
1458,8500,1523,1523,10023,1,"2016-08-30 21:25:53","2016-08-30 21:25:53"
1459,8900,1452,1452,10352,1,"2016-08-30 21:25:53","2016-08-30 21:25:53"
1460,8500,1616,1616,10116,1,"2016-08-30 21:25:53","2016-08-30 21:25:53"
1461,8900,1643,0,8900,2,"2016-08-30 21:25:53","2016-08-30 21:25:53"
1462,6000,1384,1384,7384,1,"2016-08-30 21:25:53","2016-08-30 21:25:53"
1463,9500,1494,1494,10994,1,"2016-08-30 21:25:53","2016-08-30 21:25:53"
1464,8900,1551,1551,10451,2,"2016-08-30 21:25:53","2016-08-30 21:25:53"
1465,8000,1562,1562,9562,1,"2016-08-30 21:25:53","2016-08-30 21:25:53"
1466,8000,1455,0,8000,2,"2016-08-30 21:25:53","2016-08-30 21:25:53"
1467,8500,1571,0,8500,2,"2016-08-30 21:25:53","2016-08-30 21:25:53"
1468,5000,1440,1440,6440,1,"2016-08-30 21:25:53","2016-08-30 21:25:53"
1469,5000,1409,1409,6409,1,"2016-08-30 21:25:53","2016-08-30 21:25:53"
1470,4000,1348,1348,5348,1,"2016-08-30 21:25:53","2016-08-30 21:25:53"
1471,8500,1516,1516,10016,2,"2016-08-30 21:25:53","2016-08-30 21:25:53"
1472,8000,1514,0,8000,2,"2016-08-30 21:25:53","2016-08-30 21:25:53"
1473,5000,1253,1253,6253,1,"2016-08-30 21:25:53","2016-08-30 21:25:53"
1474,5000,1273,1273,6273,1,"2016-08-30 21:25:53","2016-08-30 21:25:53"
1475,7000,1546,1546,8546,1,"2016-08-30 21:25:53","2016-08-30 21:25:53"
1476,8500,1524,0,8500,2,"2016-08-30 21:25:53","2016-08-30 21:25:53"
1477,9900,1549,1549,11449,1,"2016-08-30 21:25:53","2016-08-30 21:25:53"
1478,8900,1536,0,8900,2,"2016-08-30 21:25:53","2016-08-30 21:25:53"
1479,9900,1629,1629,11529,1,"2016-08-30 21:25:53","2016-08-30 21:25:53"
1480,8500,1455,0,8500,2,"2016-08-30 21:25:53","2016-08-30 21:25:53"
1481,9500,1576,1576,11076,2,"2016-08-30 21:25:53","2016-08-30 21:25:53"
1482,8900,1459,1459,10359,1,"2016-08-30 21:25:53","2016-08-30 21:25:53"
1483,8000,1545,1545,9545,2,"2016-08-30 21:25:53","2016-08-30 21:25:53"
1484,4000,1301,1301,5301,1,"2016-08-30 21:25:53","2016-08-30 21:25:53"
1485,8900,1561,1561,10461,1,"2016-08-30 21:25:53","2016-08-30 21:25:53"
1486,6000,1385,1385,7385,2,"2016-08-30 21:25:53","2016-08-30 21:25:53"
1487,8500,1542,0,8500,2,"2016-08-30 21:25:53","2016-08-30 21:25:53"
1488,9900,1640,1640,11540,1,"2016-08-30 21:25:53","2016-08-30 21:25:53"
1489,9900,1612,1612,11512,1,"2016-08-30 21:25:53","2016-08-30 21:25:53"
1490,4000,1208,1208,5208,2,"2016-08-30 21:25:53","2016-08-30 21:25:53"
1491,8900,1534,0,8900,2,"2016-08-30 21:25:53","2016-08-30 21:25:53"
1492,8500,1547,0,8500,2,"2016-08-30 21:25:53","2016-08-30 21:25:53"
1493,5000,1316,1316,6316,1,"2016-08-30 21:25:53","2016-08-30 21:25:53"
1494,4000,1371,1371,5371,1,"2016-08-30 21:25:53","2016-08-30 21:25:53"
1495,9900,1605,1605,11505,1,"2016-08-30 21:25:53","2016-08-30 21:25:53"
1496,9900,1603,1603,11503,1,"2016-08-30 21:25:53","2016-08-30 21:25:53"
1497,9900,1524,1524,11424,1,"2016-08-30 21:25:53","2016-08-30 21:25:53"
1498,8000,1492,0,8000,2,"2016-08-30 21:25:53","2016-08-30 21:25:53"
1499,5000,1404,1404,6404,2,"2016-08-30 21:25:53","2016-08-30 21:25:53"
1500,4000,1349,1349,5349,1,"2016-08-30 21:25:53","2016-08-30 21:25:53"
1501,8000,1531,1531,9531,1,"2016-08-30 21:25:53","2016-08-30 21:25:53"
1502,4000,1244,1244,5244,2,"2016-08-30 21:25:53","2016-08-30 21:25:53"
1503,5000,1428,1428,6428,1,"2016-08-30 21:25:53","2016-08-30 21:25:53"
1504,5000,1270,1270,6270,2,"2016-08-30 21:25:53","2016-08-30 21:25:53"
1505,4000,1235,1235,5235,2,"2016-08-30 21:25:53","2016-08-30 21:25:53"
1506,5000,1255,1255,6255,1,"2016-08-30 21:25:53","2016-08-30 21:25:53"
1507,5000,1344,1344,6344,2,"2016-08-30 21:25:53","2016-08-30 21:25:53"
1508,8900,1608,0,8900,2,"2016-08-30 21:25:53","2016-08-30 21:25:53"
1509,5000,1291,1291,6291,1,"2016-08-30 21:25:53","2016-08-30 21:25:53"
1510,8900,1524,0,8900,2,"2016-08-30 21:25:53","2016-08-30 21:25:53"
1511,4000,1315,1315,5315,1,"2016-08-30 21:25:53","2016-08-30 21:25:53"
1512,8900,1552,0,8900,2,"2016-08-30 21:25:53","2016-08-30 21:25:53"
1513,9500,1628,1628,11128,1,"2016-08-30 21:25:53","2016-08-30 21:25:53"
1514,5000,1370,1370,6370,1,"2016-08-30 21:25:53","2016-08-30 21:25:53"
1515,6000,1463,1463,7463,1,"2016-08-30 21:25:53","2016-08-30 21:25:53"
1516,8000,1470,0,8000,2,"2016-08-30 21:25:53","2016-08-30 21:25:53"
1517,9900,1554,1554,11454,1,"2016-08-30 21:25:53","2016-08-30 21:25:53"
1518,8900,1643,0,8900,2,"2016-08-30 21:25:53","2016-08-30 21:25:53"
1519,8500,1487,1487,9987,1,"2016-08-30 21:25:53","2016-08-30 21:25:53"
1520,8000,1488,0,8000,2,"2016-08-30 21:25:53","2016-08-30 21:25:53"
1521,8000,1433,1433,9433,1,"2016-08-30 21:25:53","2016-08-30 21:25:53"
1522,8000,1485,0,8000,2,"2016-08-30 21:25:53","2016-08-30 21:25:53"
1523,8900,1535,0,8900,2,"2016-08-30 21:25:53","2016-08-30 21:25:53"
1524,8900,1512,0,8900,2,"2016-08-30 21:25:53","2016-08-30 21:25:53"
1525,5000,1320,1320,6320,1,"2016-08-30 21:25:53","2016-08-30 21:25:53"
1526,4000,1258,1258,5258,1,"2016-08-30 21:25:53","2016-08-30 21:25:53"
1527,8500,1524,0,8500,2,"2016-08-30 21:25:53","2016-08-30 21:25:53"
1528,8000,1542,1542,9542,1,"2016-08-30 21:25:53","2016-08-30 21:25:53"
1529,4000,1225,1225,5225,1,"2016-08-30 21:25:53","2016-08-30 21:25:53"
1530,8900,1595,0,8900,2,"2016-08-30 21:25:53","2016-08-30 21:25:53"
1531,8500,1526,0,8500,2,"2016-08-30 21:25:53","2016-08-30 21:25:53"
1532,8000,1574,0,8000,2,"2016-08-30 21:25:53","2016-08-30 21:25:53"
1533,8000,1507,1507,9507,2,"2016-08-30 21:25:53","2016-08-30 21:25:53"
1534,8500,1469,0,8500,2,"2016-08-30 21:25:53","2016-08-30 21:25:53"
1535,8000,1564,0,8000,2,"2016-08-30 21:25:53","2016-08-30 21:25:53"
1536,9000,1523,1523,10523,1,"2016-08-30 21:25:53","2016-08-30 21:25:53"
1537,8500,1599,0,8500,2,"2016-08-30 21:25:53","2016-08-30 21:25:53"
1538,8000,1563,1563,9563,1,"2016-08-30 21:25:53","2016-08-30 21:25:53"
1539,8000,1569,0,8000,2,"2016-08-30 21:25:53","2016-08-30 21:25:53"
1540,4000,1302,1302,5302,1,"2016-08-30 21:25:53","2016-08-30 21:25:53"
1541,6000,1376,1376,7376,1,"2016-08-30 21:25:53","2016-08-30 21:25:53"
1542,8900,1504,1504,10404,2,"2016-08-30 21:25:53","2016-08-30 21:25:53"
1543,4000,1240,1240,5240,1,"2016-08-30 21:25:53","2016-08-30 21:25:53"
1544,5000,1417,1417,6417,1,"2016-08-30 21:25:53","2016-08-30 21:25:53"
1545,8500,1438,1438,9938,2,"2016-08-30 21:25:53","2016-08-30 21:25:53"
1546,8000,1432,1432,9432,1,"2016-08-30 21:25:53","2016-08-30 21:25:53"
1547,5000,1298,1298,6298,2,"2016-08-30 21:25:53","2016-08-30 21:25:53"
1548,5000,1286,1286,6286,1,"2016-08-30 21:25:53","2016-08-30 21:25:53"
1549,4000,1348,1348,5348,2,"2016-08-30 21:25:53","2016-08-30 21:25:53"
1550,7000,1437,1437,8437,1,"2016-08-30 21:25:53","2016-08-30 21:25:53"
1551,8000,1401,1401,9401,1,"2016-08-30 21:25:53","2016-08-30 21:25:53"
1552,4000,1202,1202,5202,2,"2016-08-30 21:25:53","2016-08-30 21:25:53"
1553,6000,1382,1382,7382,1,"2016-08-30 21:25:53","2016-08-30 21:25:53"
1554,8500,1471,0,8500,2,"2016-08-30 21:25:53","2016-08-30 21:25:53"
1555,8500,1559,1559,10059,1,"2016-08-30 21:25:53","2016-08-30 21:25:53"
1556,9500,1613,1613,11113,1,"2016-08-30 21:25:53","2016-08-30 21:25:53"
1557,4000,1234,1234,5234,2,"2016-08-30 21:25:53","2016-08-30 21:25:53"
1558,8000,1573,0,8000,2,"2016-08-30 21:25:53","2016-08-30 21:25:53"
1559,8000,1406,0,8000,2,"2016-08-30 21:25:53","2016-08-30 21:25:53"
1560,9900,1548,1548,11448,1,"2016-08-30 21:25:53","2016-08-30 21:25:53"
1561,8500,1558,0,8500,2,"2016-08-30 21:25:53","2016-08-30 21:25:53"
1562,7000,1516,1516,8516,2,"2016-08-30 21:25:53","2016-08-30 21:25:53"
1563,8500,1430,0,8500,2,"2016-08-30 21:25:53","2016-08-30 21:25:53"
1564,8000,1574,1574,9574,1,"2016-08-30 21:25:53","2016-08-30 21:25:53"
1565,7000,1490,1490,8490,2,"2016-08-30 21:25:53","2016-08-30 21:25:53"
1566,8500,1610,0,8500,2,"2016-08-30 21:25:53","2016-08-30 21:25:53"
1567,8000,1524,0,8000,2,"2016-08-30 21:25:53","2016-08-30 21:25:53"
1568,8500,1583,1583,10083,1,"2016-08-30 21:25:53","2016-08-30 21:25:53"
1569,9500,1584,1584,11084,1,"2016-08-30 21:25:53","2016-08-30 21:25:53"
1570,7000,1482,1482,8482,1,"2016-08-30 21:25:53","2016-08-30 21:25:53"
1571,8000,1456,1456,9456,1,"2016-08-30 21:25:53","2016-08-30 21:25:53"
1572,8000,1555,1555,9555,1,"2016-08-30 21:25:53","2016-08-30 21:25:53"
1573,5000,1370,1370,6370,1,"2016-08-30 21:25:53","2016-08-30 21:25:53"
1574,8000,1557,1557,9557,2,"2016-08-30 21:25:53","2016-08-30 21:25:53"
1575,4000,1233,1233,5233,1,"2016-08-30 21:25:53","2016-08-30 21:25:53"
1576,9900,1555,0,9900,2,"2016-08-30 21:25:53","2016-08-30 21:25:53"
1577,8000,1549,1549,9549,1,"2016-08-30 21:25:53","2016-08-30 21:25:53"
1578,9900,1536,1536,11436,1,"2016-08-30 21:25:53","2016-08-30 21:25:53"
1579,4000,1227,1227,5227,1,"2016-08-30 21:25:53","2016-08-30 21:25:53"
1580,8000,1519,0,8000,2,"2016-08-30 21:25:53","2016-08-30 21:25:53"
1581,5000,1257,1257,6257,1,"2016-08-30 21:25:53","2016-08-30 21:25:53"
1582,9900,1564,1564,11464,1,"2016-08-30 21:25:53","2016-08-30 21:25:53"
1583,8000,1486,1486,9486,1,"2016-08-30 21:25:53","2016-08-30 21:25:53"
1584,9900,1527,1527,11427,1,"2016-08-30 21:25:53","2016-08-30 21:25:53"
1585,7000,1443,1443,8443,1,"2016-08-30 21:25:53","2016-08-30 21:25:53"
1586,9500,1547,1547,11047,1,"2016-08-30 21:25:53","2016-08-30 21:25:53"
1587,8900,1450,1450,10350,2,"2016-08-30 21:25:53","2016-08-30 21:25:53"
1588,5000,1405,1405,6405,1,"2016-08-30 21:25:53","2016-08-30 21:25:53"
1589,4000,1305,1305,5305,1,"2016-08-30 21:25:53","2016-08-30 21:25:53"
1590,9900,1503,1503,11403,2,"2016-08-30 21:25:53","2016-08-30 21:25:53"
1591,8000,1431,1431,9431,2,"2016-08-30 21:25:53","2016-08-30 21:25:53"
1592,9500,1586,0,9500,2,"2016-08-30 21:25:53","2016-08-30 21:25:53"
1593,9000,1537,1537,10537,1,"2016-08-30 21:25:53","2016-08-30 21:25:53"
1594,9000,1615,1615,10615,1,"2016-08-30 21:25:53","2016-08-30 21:25:53"
1595,8000,1558,0,8000,2,"2016-08-30 21:25:53","2016-08-30 21:25:53"
1596,8000,1492,0,8000,2,"2016-08-30 21:25:53","2016-08-30 21:25:53"
1597,8000,1562,1562,9562,1,"2016-08-30 21:25:53","2016-08-30 21:25:53"
1598,9900,1647,1647,11547,1,"2016-08-30 21:25:53","2016-08-30 21:25:53"
1599,8900,1550,1550,10450,1,"2016-08-30 21:25:53","2016-08-30 21:25:53"
1600,9500,1642,0,9500,2,"2016-08-30 21:25:53","2016-08-30 21:25:53"
1601,8500,1553,0,8500,2,"2016-08-30 21:25:53","2016-08-30 21:25:53"
1602,8000,1479,1479,9479,2,"2016-08-30 21:25:53","2016-08-30 21:25:53"
1603,8500,1520,0,8500,2,"2016-08-30 21:25:53","2016-08-30 21:25:53"
1604,6000,1432,1432,7432,1,"2016-08-30 21:25:53","2016-08-30 21:25:53"
1605,5000,1430,1430,6430,2,"2016-08-30 21:25:53","2016-08-30 21:25:53"
1606,6000,1321,1321,7321,1,"2016-08-30 21:25:53","2016-08-30 21:25:53"
1607,5000,1344,1344,6344,1,"2016-08-30 21:25:53","2016-08-30 21:25:53"
1608,8000,1513,0,8000,2,"2016-08-30 21:25:53","2016-08-30 21:25:53"
1609,8000,1585,1585,9585,1,"2016-08-30 21:25:53","2016-08-30 21:25:53"
1610,8500,1564,1564,10064,1,"2016-08-30 21:25:53","2016-08-30 21:25:53"
1611,9000,1520,0,9000,2,"2016-08-30 21:25:53","2016-08-30 21:25:53"
1612,9900,1594,1594,11494,1,"2016-08-30 21:25:53","2016-08-30 21:25:53"
1613,8900,1491,1491,10391,1,"2016-08-30 21:25:53","2016-08-30 21:25:53"
1614,7000,1463,1463,8463,2,"2016-08-30 21:25:53","2016-08-30 21:25:53"
1615,8500,1431,1431,9931,1,"2016-08-30 21:25:53","2016-08-30 21:25:53"
1616,8500,1619,0,8500,2,"2016-08-30 21:25:53","2016-08-30 21:25:53"
1617,8900,1523,1523,10423,1,"2016-08-30 21:25:53","2016-08-30 21:25:53"
1618,8900,1460,0,8900,2,"2016-08-30 21:25:53","2016-08-30 21:25:53"
1619,5000,1269,1269,6269,1,"2016-08-30 21:25:53","2016-08-30 21:25:53"
1620,9000,1510,1510,10510,1,"2016-08-30 21:25:53","2016-08-30 21:25:53"
1621,8000,1407,0,8000,2,"2016-08-30 21:25:53","2016-08-30 21:25:53"
1622,9900,1509,1509,11409,2,"2016-08-30 21:25:53","2016-08-30 21:25:53"
1623,8000,1415,0,8000,2,"2016-08-30 21:25:53","2016-08-30 21:25:53"
1624,5000,1426,1426,6426,2,"2016-08-30 21:25:53","2016-08-30 21:25:53"
1625,9500,1600,0,9500,2,"2016-08-30 21:25:53","2016-08-30 21:25:53"
1626,9500,1641,0,9500,2,"2016-08-30 21:25:53","2016-08-30 21:25:53"
1627,9500,1648,1648,11148,1,"2016-08-30 21:25:53","2016-08-30 21:25:53"
1628,8900,1576,1576,10476,1,"2016-08-30 21:25:53","2016-08-30 21:25:53"
1629,9500,1500,1500,11000,1,"2016-08-30 21:25:53","2016-08-30 21:25:53"
1630,8000,1406,1406,9406,1,"2016-08-30 21:25:53","2016-08-30 21:25:53"
1631,9900,1502,1502,11402,1,"2016-08-30 21:25:53","2016-08-30 21:25:53"
1632,8000,1502,0,8000,2,"2016-08-30 21:25:53","2016-08-30 21:25:53"
1633,8000,1567,1567,9567,1,"2016-08-30 21:25:53","2016-08-30 21:25:53"
1634,8000,1574,0,8000,2,"2016-08-30 21:25:53","2016-08-30 21:25:53"
1635,9500,1481,1481,10981,1,"2016-08-30 21:25:53","2016-08-30 21:25:53"
1636,9000,1639,1639,10639,1,"2016-08-30 21:25:53","2016-08-30 21:25:53"
1637,8000,1550,0,8000,2,"2016-08-30 21:25:53","2016-08-30 21:25:53"
1638,5000,1338,1338,6338,2,"2016-08-30 21:25:53","2016-08-30 21:25:53"
1639,8900,1624,1624,10524,1,"2016-08-30 21:25:53","2016-08-30 21:25:53"
1640,8900,1511,1511,10411,2,"2016-08-30 21:25:53","2016-08-30 21:25:53"
1641,8900,1629,1629,10529,1,"2016-08-30 21:25:53","2016-08-30 21:25:53"
1642,8000,1595,0,8000,2,"2016-08-30 21:25:53","2016-08-30 21:25:53"
1643,4000,1225,1225,5225,1,"2016-08-30 21:25:53","2016-08-30 21:25:53"
1644,8500,1435,1435,9935,2,"2016-08-30 21:25:53","2016-08-30 21:25:53"
1645,9500,1602,1602,11102,1,"2016-08-30 21:25:53","2016-08-30 21:25:53"
1646,8500,1605,1605,10105,1,"2016-08-30 21:25:53","2016-08-30 21:25:53"
1647,8000,1416,0,8000,2,"2016-08-30 21:25:53","2016-08-30 21:25:53"
1648,8000,1519,0,8000,2,"2016-08-30 21:25:53","2016-08-30 21:25:53"
1649,8000,1432,0,8000,2,"2016-08-30 21:25:53","2016-08-30 21:25:53"
1650,8500,1535,0,8500,2,"2016-08-30 21:25:53","2016-08-30 21:25:53"
1651,6000,1420,1420,7420,1,"2016-08-30 21:25:53","2016-08-30 21:25:53"
1652,9900,1568,1568,11468,1,"2016-08-30 21:25:53","2016-08-30 21:25:53"
1653,8500,1523,0,8500,2,"2016-08-30 21:25:53","2016-08-30 21:25:53"
1654,9000,1473,0,9000,2,"2016-08-30 21:25:53","2016-08-30 21:25:53"
1655,5000,1437,1437,6437,2,"2016-08-30 21:25:53","2016-08-30 21:25:53"
1656,9000,1497,1497,10497,1,"2016-08-30 21:25:53","2016-08-30 21:25:53"
1657,8500,1475,1475,9975,1,"2016-08-30 21:25:53","2016-08-30 21:25:53"
1658,5000,1378,1378,6378,1,"2016-08-30 21:25:53","2016-08-30 21:25:53"
1659,5000,1420,1420,6420,2,"2016-08-30 21:25:53","2016-08-30 21:25:53"
1660,7000,1365,1365,8365,1,"2016-08-30 21:25:53","2016-08-30 21:25:53"
1661,9900,1514,0,9900,2,"2016-08-30 21:25:53","2016-08-30 21:25:53"
1662,4000,1309,1309,5309,1,"2016-08-30 21:25:53","2016-08-30 21:25:53"
1663,8000,1443,0,8000,2,"2016-08-30 21:25:53","2016-08-30 21:25:53"
1664,4000,1328,1328,5328,1,"2016-08-30 21:25:53","2016-08-30 21:25:53"
1665,9500,1616,0,9500,2,"2016-08-30 21:25:53","2016-08-30 21:25:53"
1666,9500,1539,1539,11039,1,"2016-08-30 21:25:53","2016-08-30 21:25:53"
1667,8500,1534,1534,10034,1,"2016-08-30 21:25:53","2016-08-30 21:25:53"
1668,8000,1596,1596,9596,2,"2016-08-30 21:25:53","2016-08-30 21:25:53"
1669,8900,1613,1613,10513,2,"2016-08-30 21:25:53","2016-08-30 21:25:53"
1670,8500,1555,0,8500,2,"2016-08-30 21:25:53","2016-08-30 21:25:53"
1671,5000,1390,1390,6390,1,"2016-08-30 21:25:53","2016-08-30 21:25:53"
1672,8500,1427,1427,9927,1,"2016-08-30 21:25:53","2016-08-30 21:25:53"
1673,8000,1452,1452,9452,1,"2016-08-30 21:25:53","2016-08-30 21:25:53"
1674,8900,1524,0,8900,2,"2016-08-30 21:25:53","2016-08-30 21:25:53"
1675,8500,1594,0,8500,2,"2016-08-30 21:25:53","2016-08-30 21:25:53"
1676,8500,1485,0,8500,2,"2016-08-30 21:25:53","2016-08-30 21:25:53"
1677,8000,1547,0,8000,2,"2016-08-30 21:25:53","2016-08-30 21:25:53"
1678,4000,1395,1395,5395,1,"2016-08-30 21:25:53","2016-08-30 21:25:53"
1679,6000,1398,1398,7398,2,"2016-08-30 21:25:53","2016-08-30 21:25:53"
1680,8000,1590,1590,9590,1,"2016-08-30 21:25:53","2016-08-30 21:25:53"
1681,4000,1337,1337,5337,1,"2016-08-30 21:25:53","2016-08-30 21:25:53"
1682,8000,1466,0,8000,2,"2016-08-30 21:25:53","2016-08-30 21:25:53"
1683,9000,1547,0,9000,2,"2016-08-30 21:25:53","2016-08-30 21:25:53"
1684,8000,1525,0,8000,2,"2016-08-30 21:25:53","2016-08-30 21:25:53"
1685,4000,1232,1232,5232,1,"2016-08-30 21:25:53","2016-08-30 21:25:53"
1686,7000,1410,1410,8410,2,"2016-08-30 21:25:53","2016-08-30 21:25:53"
1687,7000,1467,1467,8467,1,"2016-08-30 21:25:53","2016-08-30 21:25:53"
1688,8000,1423,0,8000,2,"2016-08-30 21:25:53","2016-08-30 21:25:53"
1689,8900,1613,1613,10513,1,"2016-08-30 21:25:53","2016-08-30 21:25:53"
1690,8900,1563,0,8900,2,"2016-08-30 21:25:53","2016-08-30 21:25:53"
1691,8000,1436,0,8000,2,"2016-08-30 21:25:53","2016-08-30 21:25:53"
1692,4000,1289,1289,5289,2,"2016-08-30 21:25:53","2016-08-30 21:25:53"
1693,4000,1278,1278,5278,2,"2016-08-30 21:25:53","2016-08-30 21:25:53"
1694,9900,1496,1496,11396,1,"2016-08-30 21:25:53","2016-08-30 21:25:53"
1695,8900,1552,1552,10452,1,"2016-08-30 21:25:53","2016-08-30 21:25:53"
1696,4000,1292,1292,5292,1,"2016-08-30 21:25:53","2016-08-30 21:25:53"
1697,8000,1410,1410,9410,1,"2016-08-30 21:25:53","2016-08-30 21:25:53"
1698,4000,1385,1385,5385,1,"2016-08-30 21:25:53","2016-08-30 21:25:53"
1699,4000,1307,1307,5307,1,"2016-08-30 21:25:53","2016-08-30 21:25:53"
1700,8500,1509,1509,10009,2,"2016-08-30 21:25:53","2016-08-30 21:25:53"
1701,8000,1499,1499,9499,1,"2016-08-30 21:25:53","2016-08-30 21:25:53"
1702,8500,1444,0,8500,2,"2016-08-30 21:25:53","2016-08-30 21:25:53"
1703,9900,1535,1535,11435,1,"2016-08-30 21:25:53","2016-08-30 21:25:53"
1704,8000,1465,0,8000,2,"2016-08-30 21:25:53","2016-08-30 21:25:53"
1705,8000,1569,1569,9569,1,"2016-08-30 21:25:53","2016-08-30 21:25:53"
1706,8900,1521,1521,10421,1,"2016-08-30 21:25:53","2016-08-30 21:25:53"
1707,7000,1537,1537,8537,2,"2016-08-30 21:25:53","2016-08-30 21:25:53"
1708,8000,1492,0,8000,2,"2016-08-30 21:25:53","2016-08-30 21:25:53"
1709,8900,1460,0,8900,2,"2016-08-30 21:25:53","2016-08-30 21:25:53"
1710,7000,1450,1450,8450,1,"2016-08-30 21:25:53","2016-08-30 21:25:53"
1711,5000,1339,1339,6339,1,"2016-08-30 21:25:54","2016-08-30 21:25:54"
1712,8000,1500,1500,9500,1,"2016-08-30 21:25:54","2016-08-30 21:25:54"
1713,4000,1272,1272,5272,2,"2016-08-30 21:25:54","2016-08-30 21:25:54"
1714,8000,1406,0,8000,2,"2016-08-30 21:25:54","2016-08-30 21:25:54"
1715,8900,1526,0,8900,2,"2016-08-30 21:25:54","2016-08-30 21:25:54"
1716,8000,1513,0,8000,2,"2016-08-30 21:25:54","2016-08-30 21:25:54"
1717,8000,1532,0,8000,2,"2016-08-30 21:25:54","2016-08-30 21:25:54"
1718,7000,1529,1529,8529,1,"2016-08-30 21:25:54","2016-08-30 21:25:54"
1719,8000,1513,0,8000,2,"2016-08-30 21:25:54","2016-08-30 21:25:54"
1720,8900,1478,1478,10378,1,"2016-08-30 21:25:54","2016-08-30 21:25:54"
1721,5000,1280,1280,6280,2,"2016-08-30 21:25:54","2016-08-30 21:25:54"
1722,5000,1447,1447,6447,1,"2016-08-30 21:25:54","2016-08-30 21:25:54"
1723,5000,1344,1344,6344,1,"2016-08-30 21:25:54","2016-08-30 21:25:54"
1724,9000,1502,1502,10502,1,"2016-08-30 21:25:54","2016-08-30 21:25:54"
1725,8500,1606,1606,10106,1,"2016-08-30 21:25:54","2016-08-30 21:25:54"
1726,8900,1558,0,8900,2,"2016-08-30 21:25:54","2016-08-30 21:25:54"
1727,8900,1613,1613,10513,1,"2016-08-30 21:25:54","2016-08-30 21:25:54"
1728,4000,1296,1296,5296,1,"2016-08-30 21:25:54","2016-08-30 21:25:54"
1729,9900,1537,1537,11437,1,"2016-08-30 21:25:54","2016-08-30 21:25:54"
1730,8000,1515,1515,9515,1,"2016-08-30 21:25:54","2016-08-30 21:25:54"
1731,8000,1548,0,8000,2,"2016-08-30 21:25:54","2016-08-30 21:25:54"
1732,6000,1338,1338,7338,2,"2016-08-30 21:25:54","2016-08-30 21:25:54"
1733,6000,1437,1437,7437,2,"2016-08-30 21:25:54","2016-08-30 21:25:54"
1734,8000,1407,1407,9407,1,"2016-08-30 21:25:54","2016-08-30 21:25:54"
1735,9500,1644,1644,11144,1,"2016-08-30 21:25:54","2016-08-30 21:25:54"
1736,8900,1592,0,8900,2,"2016-08-30 21:25:54","2016-08-30 21:25:54"
1737,4000,1200,1200,5200,1,"2016-08-30 21:25:54","2016-08-30 21:25:54"
1738,8000,1530,0,8000,2,"2016-08-30 21:25:54","2016-08-30 21:25:54"
1739,9900,1580,0,9900,2,"2016-08-30 21:25:54","2016-08-30 21:25:54"
1740,6000,1387,1387,7387,1,"2016-08-30 21:25:54","2016-08-30 21:25:54"
1741,4000,1334,1334,5334,1,"2016-08-30 21:25:54","2016-08-30 21:25:54"
1742,8000,1504,0,8000,2,"2016-08-30 21:25:54","2016-08-30 21:25:54"
1743,8500,1567,0,8500,2,"2016-08-30 21:25:54","2016-08-30 21:25:54"
1744,4000,1245,1245,5245,1,"2016-08-30 21:25:54","2016-08-30 21:25:54"
1745,8000,1507,1507,9507,1,"2016-08-30 21:25:54","2016-08-30 21:25:54"
1746,9500,1668,1668,11168,1,"2016-08-30 21:25:54","2016-08-30 21:25:54"
1747,8000,1509,0,8000,2,"2016-08-30 21:25:54","2016-08-30 21:25:54"
1748,8000,1504,1504,9504,2,"2016-08-30 21:25:54","2016-08-30 21:25:54"
1749,8500,1443,1443,9943,1,"2016-08-30 21:25:54","2016-08-30 21:25:54"
1750,4000,1262,1262,5262,2,"2016-08-30 21:25:54","2016-08-30 21:25:54"
1751,5000,1374,1374,6374,2,"2016-08-30 21:25:54","2016-08-30 21:25:54"
1752,6000,1344,1344,7344,2,"2016-08-30 21:25:54","2016-08-30 21:25:54"
1753,9900,1652,0,9900,2,"2016-08-30 21:25:54","2016-08-30 21:25:54"
1754,5000,1361,1361,6361,1,"2016-08-30 21:25:54","2016-08-30 21:25:54"
1755,4000,1262,1262,5262,1,"2016-08-30 21:25:54","2016-08-30 21:25:54"
1756,8000,1455,0,8000,2,"2016-08-30 21:25:54","2016-08-30 21:25:54"
1757,8000,1400,0,8000,2,"2016-08-30 21:25:54","2016-08-30 21:25:54"
1758,8000,1425,0,8000,2,"2016-08-30 21:25:54","2016-08-30 21:25:54"
1759,9000,1632,1632,10632,1,"2016-08-30 21:25:54","2016-08-30 21:25:54"
1760,8000,1524,0,8000,2,"2016-08-30 21:25:54","2016-08-30 21:25:54"
1761,5000,1301,1301,6301,1,"2016-08-30 21:25:54","2016-08-30 21:25:54"
1762,9900,1613,0,9900,2,"2016-08-30 21:25:54","2016-08-30 21:25:54"
1763,5000,1394,1394,6394,1,"2016-08-30 21:25:54","2016-08-30 21:25:54"
1764,9900,1516,1516,11416,1,"2016-08-30 21:25:54","2016-08-30 21:25:54"
1765,8500,1456,1456,9956,1,"2016-08-30 21:25:54","2016-08-30 21:25:54"
1766,8900,1490,0,8900,2,"2016-08-30 21:25:54","2016-08-30 21:25:54"
1767,8500,1570,1570,10070,1,"2016-08-30 21:25:54","2016-08-30 21:25:54"
1768,9000,1489,1489,10489,1,"2016-08-30 21:25:54","2016-08-30 21:25:54"
1769,8000,1568,0,8000,2,"2016-08-30 21:25:54","2016-08-30 21:25:54"
1770,8900,1473,1473,10373,1,"2016-08-30 21:25:54","2016-08-30 21:25:54"
1771,8500,1547,0,8500,2,"2016-08-30 21:25:54","2016-08-30 21:25:54"
1772,9000,1546,1546,10546,1,"2016-08-30 21:25:54","2016-08-30 21:25:54"
1773,8000,1549,0,8000,2,"2016-08-30 21:25:54","2016-08-30 21:25:54"
1774,8000,1549,0,8000,2,"2016-08-30 21:25:54","2016-08-30 21:25:54"
1775,8500,1507,0,8500,2,"2016-08-30 21:25:54","2016-08-30 21:25:54"
1776,8000,1596,1596,9596,1,"2016-08-30 21:25:54","2016-08-30 21:25:54"
1777,8500,1526,0,8500,2,"2016-08-30 21:25:54","2016-08-30 21:25:54"
1778,8500,1441,0,8500,2,"2016-08-30 21:25:54","2016-08-30 21:25:54"
1779,4000,1342,1342,5342,1,"2016-08-30 21:25:54","2016-08-30 21:25:54"
1780,4000,1341,1341,5341,1,"2016-08-30 21:25:54","2016-08-30 21:25:54"
1781,8500,1464,1464,9964,1,"2016-08-30 21:25:54","2016-08-30 21:25:54"
1782,8000,1471,1471,9471,1,"2016-08-30 21:25:54","2016-08-30 21:25:54"
1783,5000,1298,1298,6298,2,"2016-08-30 21:25:54","2016-08-30 21:25:54"
1784,5000,1427,1427,6427,1,"2016-08-30 21:25:54","2016-08-30 21:25:54"
1785,8500,1592,1592,10092,1,"2016-08-30 21:25:54","2016-08-30 21:25:54"
1786,5000,1409,1409,6409,1,"2016-08-30 21:25:54","2016-08-30 21:25:54"
1787,8000,1487,0,8000,2,"2016-08-30 21:25:54","2016-08-30 21:25:54"
1788,8000,1475,1475,9475,1,"2016-08-30 21:25:54","2016-08-30 21:25:54"
1789,9000,1550,1550,10550,1,"2016-08-30 21:25:54","2016-08-30 21:25:54"
1790,8500,1461,0,8500,2,"2016-08-30 21:25:54","2016-08-30 21:25:54"
1791,8900,1468,0,8900,2,"2016-08-30 21:25:54","2016-08-30 21:25:54"
1792,8900,1552,1552,10452,1,"2016-08-30 21:25:54","2016-08-30 21:25:54"
1793,5000,1332,1332,6332,1,"2016-08-30 21:25:54","2016-08-30 21:25:54"
1794,5000,1303,1303,6303,1,"2016-08-30 21:25:54","2016-08-30 21:25:54"
1795,9000,1599,0,9000,2,"2016-08-30 21:25:54","2016-08-30 21:25:54"
1796,5000,1265,1265,6265,2,"2016-08-30 21:25:54","2016-08-30 21:25:54"
1797,8500,1486,1486,9986,1,"2016-08-30 21:25:54","2016-08-30 21:25:54"
1798,8900,1595,1595,10495,1,"2016-08-30 21:25:54","2016-08-30 21:25:54"
1799,5000,1315,1315,6315,2,"2016-08-30 21:25:54","2016-08-30 21:25:54"
1800,5000,1285,1285,6285,1,"2016-08-30 21:25:54","2016-08-30 21:25:54"
1801,8500,1574,0,8500,2,"2016-08-30 21:25:54","2016-08-30 21:25:54"
1802,8500,1591,0,8500,2,"2016-08-30 21:25:54","2016-08-30 21:25:54"
1803,8000,1565,0,8000,2,"2016-08-30 21:25:54","2016-08-30 21:25:54"
1804,8000,1534,0,8000,2,"2016-08-30 21:25:54","2016-08-30 21:25:54"
1805,8000,1499,0,8000,2,"2016-08-30 21:25:54","2016-08-30 21:25:54"
1806,8000,1562,1562,9562,1,"2016-08-30 21:25:54","2016-08-30 21:25:54"
1807,8000,1586,0,8000,2,"2016-08-30 21:25:54","2016-08-30 21:25:54"
1808,9900,1598,1598,11498,1,"2016-08-30 21:25:54","2016-08-30 21:25:54"
1809,8000,1459,1459,9459,1,"2016-08-30 21:25:54","2016-08-30 21:25:54"
1810,8500,1609,1609,10109,1,"2016-08-30 21:25:54","2016-08-30 21:25:54"
1811,8000,1551,0,8000,2,"2016-08-30 21:25:54","2016-08-30 21:25:54"
1812,8000,1526,0,8000,2,"2016-08-30 21:25:54","2016-08-30 21:25:54"
1813,8000,1469,0,8000,2,"2016-08-30 21:25:54","2016-08-30 21:25:54"
1814,8000,1438,1438,9438,1,"2016-08-30 21:25:54","2016-08-30 21:25:54"
1815,8500,1471,0,8500,2,"2016-08-30 21:25:54","2016-08-30 21:25:54"
1816,8000,1408,0,8000,2,"2016-08-30 21:25:54","2016-08-30 21:25:54"
1817,8000,1594,1594,9594,2,"2016-08-30 21:25:54","2016-08-30 21:25:54"
1818,9900,1680,0,9900,2,"2016-08-30 21:25:54","2016-08-30 21:25:54"
1819,8900,1459,1459,10359,1,"2016-08-30 21:25:54","2016-08-30 21:25:54"
1820,8500,1531,1531,10031,1,"2016-08-30 21:25:54","2016-08-30 21:25:54"
1821,9500,1620,1620,11120,2,"2016-08-30 21:25:54","2016-08-30 21:25:54"
1822,7000,1435,1435,8435,2,"2016-08-30 21:25:54","2016-08-30 21:25:54"
1823,8500,1513,0,8500,2,"2016-08-30 21:25:54","2016-08-30 21:25:54"
1824,9900,1600,1600,11500,1,"2016-08-30 21:25:54","2016-08-30 21:25:54"
1825,9000,1461,1461,10461,1,"2016-08-30 21:25:54","2016-08-30 21:25:54"
1826,9000,1565,1565,10565,1,"2016-08-30 21:25:54","2016-08-30 21:25:54"
1827,8000,1491,1491,9491,1,"2016-08-30 21:25:54","2016-08-30 21:25:54"
1828,8500,1476,0,8500,2,"2016-08-30 21:25:54","2016-08-30 21:25:54"
1829,8000,1410,1410,9410,2,"2016-08-30 21:25:54","2016-08-30 21:25:54"
1830,8500,1490,0,8500,2,"2016-08-30 21:25:54","2016-08-30 21:25:54"
1831,8000,1590,0,8000,2,"2016-08-30 21:25:54","2016-08-30 21:25:54"
1832,9900,1627,1627,11527,1,"2016-08-30 21:25:54","2016-08-30 21:25:54"
1833,8900,1615,0,8900,2,"2016-08-30 21:25:54","2016-08-30 21:25:54"
1834,8900,1593,0,8900,2,"2016-08-30 21:25:54","2016-08-30 21:25:54"
1835,9500,1639,1639,11139,1,"2016-08-30 21:25:54","2016-08-30 21:25:54"
1836,5000,1253,1253,6253,1,"2016-08-30 21:25:54","2016-08-30 21:25:54"
1837,8500,1515,1515,10015,2,"2016-08-30 21:25:54","2016-08-30 21:25:54"
1838,8500,1608,1608,10108,1,"2016-08-30 21:25:54","2016-08-30 21:25:54"
1839,8000,1464,1464,9464,2,"2016-08-30 21:25:54","2016-08-30 21:25:54"
1840,8900,1471,0,8900,2,"2016-08-30 21:25:54","2016-08-30 21:25:54"
1841,8000,1519,0,8000,2,"2016-08-30 21:25:54","2016-08-30 21:25:54"
1842,7000,1531,1531,8531,1,"2016-08-30 21:25:54","2016-08-30 21:25:54"
1843,4000,1245,1245,5245,1,"2016-08-30 21:25:54","2016-08-30 21:25:54"
1844,9000,1514,1514,10514,1,"2016-08-30 21:25:54","2016-08-30 21:25:54"
1845,9000,1521,0,9000,2,"2016-08-30 21:25:54","2016-08-30 21:25:54"
1846,4000,1347,1347,5347,2,"2016-08-30 21:25:54","2016-08-30 21:25:54"
1847,4000,1353,1353,5353,1,"2016-08-30 21:25:54","2016-08-30 21:25:54"
1848,8000,1488,1488,9488,1,"2016-08-30 21:25:54","2016-08-30 21:25:54"
1849,8000,1412,1412,9412,2,"2016-08-30 21:25:54","2016-08-30 21:25:54"
1850,4000,1298,1298,5298,1,"2016-08-30 21:25:54","2016-08-30 21:25:54"
1851,8500,1454,0,8500,2,"2016-08-30 21:25:54","2016-08-30 21:25:54"
1852,8000,1462,0,8000,2,"2016-08-30 21:25:54","2016-08-30 21:25:54"
1853,9900,1657,1657,11557,2,"2016-08-30 21:25:54","2016-08-30 21:25:54"
1854,5000,1355,1355,6355,2,"2016-08-30 21:25:54","2016-08-30 21:25:54"
1855,8900,1556,1556,10456,1,"2016-08-30 21:25:54","2016-08-30 21:25:54"
1856,8500,1551,0,8500,2,"2016-08-30 21:25:54","2016-08-30 21:25:54"
1857,8500,1438,1438,9938,2,"2016-08-30 21:25:54","2016-08-30 21:25:54"
1858,9900,1673,0,9900,2,"2016-08-30 21:25:54","2016-08-30 21:25:54"
1859,4000,1370,1370,5370,2,"2016-08-30 21:25:54","2016-08-30 21:25:54"
1860,8900,1455,0,8900,2,"2016-08-30 21:25:54","2016-08-30 21:25:54"
1861,7000,1498,1498,8498,1,"2016-08-30 21:25:54","2016-08-30 21:25:54"
1862,9900,1613,1613,11513,1,"2016-08-30 21:25:54","2016-08-30 21:25:54"
1863,8900,1544,1544,10444,2,"2016-08-30 21:25:54","2016-08-30 21:25:54"
1864,4000,1353,1353,5353,1,"2016-08-30 21:25:54","2016-08-30 21:25:54"
1865,8000,1423,1423,9423,2,"2016-08-30 21:25:54","2016-08-30 21:25:54"
1866,8900,1524,1524,10424,1,"2016-08-30 21:25:54","2016-08-30 21:25:54"
1867,9500,1516,1516,11016,1,"2016-08-30 21:25:54","2016-08-30 21:25:54"
1868,9500,1569,1569,11069,1,"2016-08-30 21:25:54","2016-08-30 21:25:54"
1869,4000,1313,1313,5313,1,"2016-08-30 21:25:54","2016-08-30 21:25:54"
1870,8000,1416,1416,9416,1,"2016-08-30 21:25:54","2016-08-30 21:25:54"
1871,4000,1343,1343,5343,1,"2016-08-30 21:25:54","2016-08-30 21:25:54"
1872,8000,1582,1582,9582,2,"2016-08-30 21:25:54","2016-08-30 21:25:54"
1873,9500,1504,1504,11004,1,"2016-08-30 21:25:54","2016-08-30 21:25:54"
1874,5000,1383,1383,6383,2,"2016-08-30 21:25:54","2016-08-30 21:25:54"
1875,8900,1586,1586,10486,1,"2016-08-30 21:25:54","2016-08-30 21:25:54"
1876,9000,1608,1608,10608,1,"2016-08-30 21:25:54","2016-08-30 21:25:54"
1877,6000,1378,1378,7378,1,"2016-08-30 21:25:54","2016-08-30 21:25:54"
1878,6000,1305,1305,7305,1,"2016-08-30 21:25:54","2016-08-30 21:25:54"
1879,5000,1324,1324,6324,1,"2016-08-30 21:25:54","2016-08-30 21:25:54"
1880,8500,1465,1465,9965,1,"2016-08-30 21:25:54","2016-08-30 21:25:54"
1881,8500,1427,0,8500,2,"2016-08-30 21:25:54","2016-08-30 21:25:54"
1882,8000,1490,0,8000,2,"2016-08-30 21:25:54","2016-08-30 21:25:54"
1883,6000,1356,1356,7356,1,"2016-08-30 21:25:54","2016-08-30 21:25:54"
1884,8900,1578,0,8900,2,"2016-08-30 21:25:54","2016-08-30 21:25:54"
1885,9900,1580,0,9900,2,"2016-08-30 21:25:54","2016-08-30 21:25:54"
1886,4000,1288,1288,5288,1,"2016-08-30 21:25:54","2016-08-30 21:25:54"
1887,8000,1405,1405,9405,1,"2016-08-30 21:25:54","2016-08-30 21:25:54"
1888,8900,1627,0,8900,2,"2016-08-30 21:25:54","2016-08-30 21:25:54"
1889,8500,1543,0,8500,2,"2016-08-30 21:25:54","2016-08-30 21:25:54"
1890,9900,1548,1548,11448,1,"2016-08-30 21:25:54","2016-08-30 21:25:54"
1891,8900,1575,0,8900,2,"2016-08-30 21:25:54","2016-08-30 21:25:54"
1892,9900,1642,1642,11542,1,"2016-08-30 21:25:54","2016-08-30 21:25:54"
1893,8500,1515,0,8500,2,"2016-08-30 21:25:54","2016-08-30 21:25:54"
1894,9500,1596,1596,11096,1,"2016-08-30 21:25:54","2016-08-30 21:25:54"
1895,6000,1309,1309,7309,1,"2016-08-30 21:25:54","2016-08-30 21:25:54"
1896,8000,1454,1454,9454,2,"2016-08-30 21:25:54","2016-08-30 21:25:54"
1897,7000,1542,1542,8542,2,"2016-08-30 21:25:54","2016-08-30 21:25:54"
1898,8500,1458,0,8500,2,"2016-08-30 21:25:54","2016-08-30 21:25:54"
1899,4000,1231,1231,5231,1,"2016-08-30 21:25:54","2016-08-30 21:25:54"
1900,7000,1480,1480,8480,1,"2016-08-30 21:25:54","2016-08-30 21:25:54"
1901,8500,1549,0,8500,2,"2016-08-30 21:25:54","2016-08-30 21:25:54"
1902,8900,1545,0,8900,2,"2016-08-30 21:25:54","2016-08-30 21:25:54"
1903,9900,1678,1678,11578,1,"2016-08-30 21:25:54","2016-08-30 21:25:54"
1904,8000,1565,1565,9565,1,"2016-08-30 21:25:54","2016-08-30 21:25:54"
1905,8500,1544,1544,10044,2,"2016-08-30 21:25:54","2016-08-30 21:25:54"
1906,8000,1416,0,8000,2,"2016-08-30 21:25:54","2016-08-30 21:25:54"
1907,8900,1509,0,8900,2,"2016-08-30 21:25:54","2016-08-30 21:25:54"
1908,7000,1410,1410,8410,1,"2016-08-30 21:25:54","2016-08-30 21:25:54"
1909,8500,1554,1554,10054,1,"2016-08-30 21:25:54","2016-08-30 21:25:54"
1910,8000,1478,1478,9478,1,"2016-08-30 21:25:54","2016-08-30 21:25:54"
1911,4000,1259,1259,5259,1,"2016-08-30 21:25:54","2016-08-30 21:25:54"
1912,8000,1447,0,8000,2,"2016-08-30 21:25:54","2016-08-30 21:25:54"
1913,4000,1281,1281,5281,1,"2016-08-30 21:25:54","2016-08-30 21:25:54"
1914,5000,1303,1303,6303,1,"2016-08-30 21:25:54","2016-08-30 21:25:54"
1915,8000,1591,0,8000,2,"2016-08-30 21:25:54","2016-08-30 21:25:54"
1916,9000,1470,1470,10470,1,"2016-08-30 21:25:54","2016-08-30 21:25:54"
1917,5000,1315,1315,6315,2,"2016-08-30 21:25:54","2016-08-30 21:25:54"
1918,8900,1639,1639,10539,1,"2016-08-30 21:25:54","2016-08-30 21:25:54"
1919,9500,1666,1666,11166,1,"2016-08-30 21:25:54","2016-08-30 21:25:54"
1920,9000,1626,1626,10626,1,"2016-08-30 21:25:54","2016-08-30 21:25:54"
1921,8000,1537,0,8000,2,"2016-08-30 21:25:54","2016-08-30 21:25:54"
1922,9900,1561,1561,11461,1,"2016-08-30 21:25:54","2016-08-30 21:25:54"
1923,9500,1546,1546,11046,1,"2016-08-30 21:25:54","2016-08-30 21:25:54"
1924,8500,1622,1622,10122,1,"2016-08-30 21:25:54","2016-08-30 21:25:54"
1925,9500,1553,1553,11053,1,"2016-08-30 21:25:54","2016-08-30 21:25:54"
1926,7000,1502,1502,8502,1,"2016-08-30 21:25:54","2016-08-30 21:25:54"
1927,8500,1563,0,8500,2,"2016-08-30 21:25:54","2016-08-30 21:25:54"
1928,8500,1461,1461,9961,1,"2016-08-30 21:25:54","2016-08-30 21:25:54"
1929,8900,1496,1496,10396,2,"2016-08-30 21:25:54","2016-08-30 21:25:54"
1930,8500,1425,1425,9925,2,"2016-08-30 21:25:54","2016-08-30 21:25:54"
1931,8500,1480,1480,9980,1,"2016-08-30 21:25:54","2016-08-30 21:25:54"
1932,8500,1611,1611,10111,2,"2016-08-30 21:25:54","2016-08-30 21:25:54"
1933,5000,1316,1316,6316,2,"2016-08-30 21:25:54","2016-08-30 21:25:54"
1934,8000,1496,0,8000,2,"2016-08-30 21:25:54","2016-08-30 21:25:54"
1935,8000,1425,0,8000,2,"2016-08-30 21:25:54","2016-08-30 21:25:54"
1936,8000,1475,1475,9475,1,"2016-08-30 21:25:54","2016-08-30 21:25:54"
1937,8500,1569,1569,10069,2,"2016-08-30 21:25:54","2016-08-30 21:25:54"
1938,8000,1520,0,8000,2,"2016-08-30 21:25:54","2016-08-30 21:25:54"
1939,9500,1635,1635,11135,1,"2016-08-30 21:25:54","2016-08-30 21:25:54"
1940,8000,1544,0,8000,2,"2016-08-30 21:25:54","2016-08-30 21:25:54"
1941,5000,1252,1252,6252,2,"2016-08-30 21:25:54","2016-08-30 21:25:54"
1942,7000,1431,1431,8431,2,"2016-08-30 21:25:54","2016-08-30 21:25:54"
1943,5000,1447,1447,6447,1,"2016-08-30 21:25:54","2016-08-30 21:25:54"
1944,9900,1552,1552,11452,1,"2016-08-30 21:25:54","2016-08-30 21:25:54"
1945,8900,1496,1496,10396,1,"2016-08-30 21:25:54","2016-08-30 21:25:54"
1946,5000,1416,1416,6416,1,"2016-08-30 21:25:54","2016-08-30 21:25:54"
1947,8500,1591,0,8500,2,"2016-08-30 21:25:54","2016-08-30 21:25:54"
1948,8900,1529,0,8900,2,"2016-08-30 21:25:54","2016-08-30 21:25:54"
1949,4000,1213,1213,5213,1,"2016-08-30 21:25:54","2016-08-30 21:25:54"
1950,6000,1405,1405,7405,1,"2016-08-30 21:25:54","2016-08-30 21:25:54"
1951,8500,1485,0,8500,2,"2016-08-30 21:25:54","2016-08-30 21:25:54"
1952,8900,1612,0,8900,2,"2016-08-30 21:25:54","2016-08-30 21:25:54"
1953,5000,1321,1321,6321,1,"2016-08-30 21:25:54","2016-08-30 21:25:54"
1954,5000,1411,1411,6411,2,"2016-08-30 21:25:54","2016-08-30 21:25:54"
1955,8900,1482,1482,10382,2,"2016-08-30 21:25:54","2016-08-30 21:25:54"
1956,9500,1540,1540,11040,2,"2016-08-30 21:25:54","2016-08-30 21:25:54"
1957,9900,1562,1562,11462,1,"2016-08-30 21:25:54","2016-08-30 21:25:54"
1958,8500,1598,0,8500,2,"2016-08-30 21:25:54","2016-08-30 21:25:54"
1959,5000,1402,1402,6402,1,"2016-08-30 21:25:54","2016-08-30 21:25:54"
1960,8000,1576,0,8000,2,"2016-08-30 21:25:54","2016-08-30 21:25:54"
1961,9500,1603,1603,11103,1,"2016-08-30 21:25:54","2016-08-30 21:25:54"
1962,5000,1274,1274,6274,1,"2016-08-30 21:25:54","2016-08-30 21:25:54"
1963,4000,1309,1309,5309,1,"2016-08-30 21:25:54","2016-08-30 21:25:54"
1964,9500,1512,1512,11012,1,"2016-08-30 21:25:54","2016-08-30 21:25:54"
1965,8900,1553,1553,10453,1,"2016-08-30 21:25:54","2016-08-30 21:25:54"
1966,8000,1495,0,8000,2,"2016-08-30 21:25:54","2016-08-30 21:25:54"
1967,7000,1545,1545,8545,2,"2016-08-30 21:25:54","2016-08-30 21:25:54"
1968,8000,1481,0,8000,2,"2016-08-30 21:25:54","2016-08-30 21:25:54"
1969,8000,1498,0,8000,2,"2016-08-30 21:25:54","2016-08-30 21:25:54"
1970,8900,1589,0,8900,2,"2016-08-30 21:25:54","2016-08-30 21:25:54"
1971,9000,1588,1588,10588,1,"2016-08-30 21:25:54","2016-08-30 21:25:54"
1972,4000,1263,1263,5263,1,"2016-08-30 21:25:54","2016-08-30 21:25:54"
1973,8000,1586,0,8000,2,"2016-08-30 21:25:54","2016-08-30 21:25:54"
1974,8500,1432,1432,9932,1,"2016-08-30 21:25:54","2016-08-30 21:25:54"
1975,8000,1567,0,8000,2,"2016-08-30 21:25:54","2016-08-30 21:25:54"
1976,8500,1582,1582,10082,1,"2016-08-30 21:25:54","2016-08-30 21:25:54"
1977,8000,1588,0,8000,2,"2016-08-30 21:25:54","2016-08-30 21:25:54"
1978,8900,1497,0,8900,2,"2016-08-30 21:25:54","2016-08-30 21:25:54"
1979,8000,1560,0,8000,2,"2016-08-30 21:25:54","2016-08-30 21:25:54"
1980,8500,1545,1545,10045,2,"2016-08-30 21:25:54","2016-08-30 21:25:54"
1981,4000,1320,1320,5320,2,"2016-08-30 21:25:54","2016-08-30 21:25:54"
1982,8000,1479,0,8000,2,"2016-08-30 21:25:54","2016-08-30 21:25:54"
1983,9900,1563,1563,11463,1,"2016-08-30 21:25:54","2016-08-30 21:25:54"
1984,8500,1558,1558,10058,1,"2016-08-30 21:25:54","2016-08-30 21:25:54"
1985,8000,1432,1432,9432,1,"2016-08-30 21:25:54","2016-08-30 21:25:54"
1986,8500,1526,0,8500,2,"2016-08-30 21:25:54","2016-08-30 21:25:54"
1987,6000,1369,1369,7369,2,"2016-08-30 21:25:54","2016-08-30 21:25:54"
1988,9900,1693,1693,11593,1,"2016-08-30 21:25:54","2016-08-30 21:25:54"
1989,7000,1508,1508,8508,1,"2016-08-30 21:25:54","2016-08-30 21:25:54"
1990,8500,1556,1556,10056,1,"2016-08-30 21:25:54","2016-08-30 21:25:54"
1991,8500,1535,1535,10035,1,"2016-08-30 21:25:54","2016-08-30 21:25:54"
1992,5000,1413,1413,6413,1,"2016-08-30 21:25:54","2016-08-30 21:25:54"
1993,8000,1567,0,8000,2,"2016-08-30 21:25:54","2016-08-30 21:25:54"
1994,5000,1282,1282,6282,1,"2016-08-30 21:25:54","2016-08-30 21:25:54"
1995,5000,1334,1334,6334,2,"2016-08-30 21:25:54","2016-08-30 21:25:54"
1996,9000,1611,1611,10611,1,"2016-08-30 21:25:54","2016-08-30 21:25:54"
1997,9900,1672,1672,11572,1,"2016-08-30 21:25:54","2016-08-30 21:25:54"
1998,4000,1345,1345,5345,1,"2016-08-30 21:25:54","2016-08-30 21:25:54"
1999,9900,1659,0,9900,2,"2016-08-30 21:25:54","2016-08-30 21:25:54"
2000,4000,1259,1259,5259,1,"2016-08-30 21:25:54","2016-08-30 21:25:54"
2001,8500,1622,1622,10122,2,"2016-08-30 21:25:54","2016-08-30 21:25:54"
2002,5000,1320,1320,6320,2,"2016-08-30 21:25:54","2016-08-30 21:25:54"
2003,9500,1528,1528,11028,1,"2016-08-30 21:25:54","2016-08-30 21:25:54"
2004,6000,1446,1446,7446,1,"2016-08-30 21:25:54","2016-08-30 21:25:54"
2005,5000,1378,1378,6378,2,"2016-08-30 21:25:54","2016-08-30 21:25:54"
2006,6000,1341,1341,7341,1,"2016-08-30 21:25:54","2016-08-30 21:25:54"
2007,9900,1600,1600,11500,1,"2016-08-30 21:25:54","2016-08-30 21:25:54"
2008,5000,1442,1442,6442,2,"2016-08-30 21:25:54","2016-08-30 21:25:54"
2009,8900,1625,1625,10525,2,"2016-08-30 21:25:54","2016-08-30 21:25:54"
2010,8000,1588,0,8000,2,"2016-08-30 21:25:54","2016-08-30 21:25:54"
2011,5000,1358,1358,6358,1,"2016-08-30 21:25:54","2016-08-30 21:25:54"
2012,8000,1548,1548,9548,1,"2016-08-30 21:25:54","2016-08-30 21:25:54"
2013,4000,1311,1311,5311,1,"2016-08-30 21:25:54","2016-08-30 21:25:54"
2014,9000,1579,0,9000,2,"2016-08-30 21:25:54","2016-08-30 21:25:54"
2015,4000,1319,1319,5319,2,"2016-08-30 21:25:54","2016-08-30 21:25:54"
2016,8900,1522,0,8900,2,"2016-08-30 21:25:54","2016-08-30 21:25:54"
2017,5000,1285,1285,6285,1,"2016-08-30 21:25:54","2016-08-30 21:25:54"
2018,6000,1383,1383,7383,2,"2016-08-30 21:25:54","2016-08-30 21:25:54"
2019,6000,1455,1455,7455,1,"2016-08-30 21:25:54","2016-08-30 21:25:54"
2020,4000,1364,1364,5364,1,"2016-08-30 21:25:54","2016-08-30 21:25:54"
2021,9900,1641,1641,11541,1,"2016-08-30 21:25:54","2016-08-30 21:25:54"
2022,8500,1609,0,8500,2,"2016-08-30 21:25:54","2016-08-30 21:25:54"
2023,8000,1549,0,8000,2,"2016-08-30 21:25:54","2016-08-30 21:25:54"
2024,7000,1462,1462,8462,1,"2016-08-30 21:25:55","2016-08-30 21:25:55"
2025,5000,1427,1427,6427,1,"2016-08-30 21:25:55","2016-08-30 21:25:55"
2026,4000,1291,1291,5291,1,"2016-08-30 21:25:55","2016-08-30 21:25:55"
2027,9500,1572,1572,11072,1,"2016-08-30 21:25:55","2016-08-30 21:25:55"
2028,7000,1417,1417,8417,1,"2016-08-30 21:25:55","2016-08-30 21:25:55"
2029,9900,1517,1517,11417,1,"2016-08-30 21:25:55","2016-08-30 21:25:55"
2030,9900,1544,1544,11444,1,"2016-08-30 21:25:55","2016-08-30 21:25:55"
2031,8900,1458,0,8900,2,"2016-08-30 21:25:55","2016-08-30 21:25:55"
2032,9900,1683,1683,11583,1,"2016-08-30 21:25:55","2016-08-30 21:25:55"
2033,7000,1369,1369,8369,1,"2016-08-30 21:25:55","2016-08-30 21:25:55"
2034,8900,1537,1537,10437,2,"2016-08-30 21:25:55","2016-08-30 21:25:55"
2035,9500,1526,0,9500,2,"2016-08-30 21:25:55","2016-08-30 21:25:55"
2036,9900,1571,1571,11471,1,"2016-08-30 21:25:55","2016-08-30 21:25:55"
2037,4000,1331,1331,5331,2,"2016-08-30 21:25:55","2016-08-30 21:25:55"
2038,8500,1614,1614,10114,1,"2016-08-30 21:25:55","2016-08-30 21:25:55"
2039,8900,1619,1619,10519,1,"2016-08-30 21:25:55","2016-08-30 21:25:55"
2040,4000,1367,1367,5367,2,"2016-08-30 21:25:55","2016-08-30 21:25:55"
2041,7000,1438,1438,8438,1,"2016-08-30 21:25:55","2016-08-30 21:25:55"
2042,8000,1531,0,8000,2,"2016-08-30 21:25:55","2016-08-30 21:25:55"
2043,8500,1427,0,8500,2,"2016-08-30 21:25:55","2016-08-30 21:25:55"
2044,4000,1304,1304,5304,1,"2016-08-30 21:25:55","2016-08-30 21:25:55"
2045,8000,1429,0,8000,2,"2016-08-30 21:25:55","2016-08-30 21:25:55"
2046,8500,1446,0,8500,2,"2016-08-30 21:25:55","2016-08-30 21:25:55"
2047,4000,1393,1393,5393,1,"2016-08-30 21:25:55","2016-08-30 21:25:55"
2048,8000,1414,0,8000,2,"2016-08-30 21:25:55","2016-08-30 21:25:55"
2049,4000,1277,1277,5277,2,"2016-08-30 21:25:55","2016-08-30 21:25:55"
2050,8000,1556,0,8000,2,"2016-08-30 21:25:55","2016-08-30 21:25:55"
2051,8500,1526,1526,10026,1,"2016-08-30 21:25:55","2016-08-30 21:25:55"
2052,8900,1449,0,8900,2,"2016-08-30 21:25:55","2016-08-30 21:25:55"
2053,5000,1295,1295,6295,2,"2016-08-30 21:25:55","2016-08-30 21:25:55"
2054,8000,1406,0,8000,2,"2016-08-30 21:25:55","2016-08-30 21:25:55"
2055,5000,1388,1388,6388,1,"2016-08-30 21:25:55","2016-08-30 21:25:55"
2056,4000,1253,1253,5253,1,"2016-08-30 21:25:55","2016-08-30 21:25:55"
2057,8000,1544,1544,9544,2,"2016-08-30 21:25:55","2016-08-30 21:25:55"
2058,8900,1605,0,8900,2,"2016-08-30 21:25:55","2016-08-30 21:25:55"
2059,4000,1297,1297,5297,1,"2016-08-30 21:25:55","2016-08-30 21:25:55"
2060,8000,1587,0,8000,2,"2016-08-30 21:25:55","2016-08-30 21:25:55"
2061,8500,1578,0,8500,2,"2016-08-30 21:25:55","2016-08-30 21:25:55"
2062,5000,1334,1334,6334,1,"2016-08-30 21:25:55","2016-08-30 21:25:55"
2063,9900,1616,0,9900,2,"2016-08-30 21:25:55","2016-08-30 21:25:55"
2064,5000,1255,1255,6255,1,"2016-08-30 21:25:55","2016-08-30 21:25:55"
2065,9900,1509,1509,11409,2,"2016-08-30 21:25:55","2016-08-30 21:25:55"
2066,8500,1525,0,8500,2,"2016-08-30 21:25:55","2016-08-30 21:25:55"
2067,8000,1554,1554,9554,1,"2016-08-30 21:25:55","2016-08-30 21:25:55"
2068,5000,1301,1301,6301,2,"2016-08-30 21:25:55","2016-08-30 21:25:55"
2069,9500,1505,1505,11005,1,"2016-08-30 21:25:55","2016-08-30 21:25:55"
2070,9000,1541,1541,10541,1,"2016-08-30 21:25:55","2016-08-30 21:25:55"
2071,7000,1402,1402,8402,1,"2016-08-30 21:25:55","2016-08-30 21:25:55"
2072,9500,1665,1665,11165,1,"2016-08-30 21:25:55","2016-08-30 21:25:55"
2073,8500,1452,0,8500,2,"2016-08-30 21:25:55","2016-08-30 21:25:55"
2074,8500,1465,1465,9965,1,"2016-08-30 21:25:55","2016-08-30 21:25:55"
2075,5000,1408,1408,6408,1,"2016-08-30 21:25:55","2016-08-30 21:25:55"
2076,9500,1526,1526,11026,1,"2016-08-30 21:25:55","2016-08-30 21:25:55"
2077,8000,1562,1562,9562,1,"2016-08-30 21:25:55","2016-08-30 21:25:55"
2078,8900,1445,0,8900,2,"2016-08-30 21:25:55","2016-08-30 21:25:55"
2079,8500,1498,1498,9998,2,"2016-08-30 21:25:55","2016-08-30 21:25:55"
2080,9500,1662,1662,11162,1,"2016-08-30 21:25:55","2016-08-30 21:25:55"
2081,8900,1607,0,8900,2,"2016-08-30 21:25:55","2016-08-30 21:25:55"
2082,9500,1670,1670,11170,1,"2016-08-30 21:25:55","2016-08-30 21:25:55"
2083,8000,1581,1581,9581,2,"2016-08-30 21:25:55","2016-08-30 21:25:55"
2084,8000,1526,1526,9526,1,"2016-08-30 21:25:55","2016-08-30 21:25:55"
2085,8000,1408,1408,9408,2,"2016-08-30 21:25:55","2016-08-30 21:25:55"
2086,8500,1472,1472,9972,1,"2016-08-30 21:25:55","2016-08-30 21:25:55"
2087,8000,1564,1564,9564,1,"2016-08-30 21:25:55","2016-08-30 21:25:55"
2088,6000,1319,1319,7319,1,"2016-08-30 21:25:55","2016-08-30 21:25:55"
2089,5000,1255,1255,6255,1,"2016-08-30 21:25:55","2016-08-30 21:25:55"
2090,8500,1448,0,8500,2,"2016-08-30 21:25:55","2016-08-30 21:25:55"
2091,8000,1546,1546,9546,1,"2016-08-30 21:25:55","2016-08-30 21:25:55"
2092,8900,1544,1544,10444,2,"2016-08-30 21:25:55","2016-08-30 21:25:55"
2093,4000,1377,1377,5377,1,"2016-08-30 21:25:55","2016-08-30 21:25:55"
2094,8000,1513,1513,9513,2,"2016-08-30 21:25:55","2016-08-30 21:25:55"
2095,9900,1666,1666,11566,2,"2016-08-30 21:25:55","2016-08-30 21:25:55"
2096,9900,1533,1533,11433,1,"2016-08-30 21:25:55","2016-08-30 21:25:55"
2097,8500,1585,0,8500,2,"2016-08-30 21:25:55","2016-08-30 21:25:55"
2098,8900,1538,1538,10438,2,"2016-08-30 21:25:55","2016-08-30 21:25:55"
2099,4000,1391,1391,5391,1,"2016-08-30 21:25:55","2016-08-30 21:25:55"
2100,9500,1631,1631,11131,1,"2016-08-30 21:25:55","2016-08-30 21:25:55"
2101,4000,1359,1359,5359,1,"2016-08-30 21:25:55","2016-08-30 21:25:55"
2102,8500,1568,0,8500,2,"2016-08-30 21:25:55","2016-08-30 21:25:55"
2103,8900,1582,1582,10482,1,"2016-08-30 21:25:55","2016-08-30 21:25:55"
2104,8000,1478,1478,9478,2,"2016-08-30 21:25:55","2016-08-30 21:25:55"
2105,8900,1525,0,8900,2,"2016-08-30 21:25:55","2016-08-30 21:25:55"
2106,8000,1556,0,8000,2,"2016-08-30 21:25:55","2016-08-30 21:25:55"
2107,8500,1447,1447,9947,2,"2016-08-30 21:25:55","2016-08-30 21:25:55"
2108,9900,1553,0,9900,2,"2016-08-30 21:25:55","2016-08-30 21:25:55"
2109,9900,1572,1572,11472,1,"2016-08-30 21:25:55","2016-08-30 21:25:55"
2110,8000,1523,0,8000,2,"2016-08-30 21:25:55","2016-08-30 21:25:55"
2111,9900,1691,0,9900,2,"2016-08-30 21:25:55","2016-08-30 21:25:55"
2112,8000,1532,1532,9532,2,"2016-08-30 21:25:55","2016-08-30 21:25:55"
2113,9500,1630,1630,11130,1,"2016-08-30 21:25:55","2016-08-30 21:25:55"
2114,8500,1458,0,8500,2,"2016-08-30 21:25:55","2016-08-30 21:25:55"
2115,9900,1624,1624,11524,1,"2016-08-30 21:25:55","2016-08-30 21:25:55"
2116,8900,1473,1473,10373,1,"2016-08-30 21:25:55","2016-08-30 21:25:55"
2117,8500,1581,1581,10081,1,"2016-08-30 21:25:55","2016-08-30 21:25:55"
2118,6000,1404,1404,7404,1,"2016-08-30 21:25:55","2016-08-30 21:25:55"
2119,9000,1646,1646,10646,1,"2016-08-30 21:25:55","2016-08-30 21:25:55"
2120,8500,1576,1576,10076,1,"2016-08-30 21:25:55","2016-08-30 21:25:55"
2121,4000,1231,1231,5231,1,"2016-08-30 21:25:55","2016-08-30 21:25:55"
2122,8900,1584,1584,10484,1,"2016-08-30 21:25:55","2016-08-30 21:25:55"
2123,8500,1480,0,8500,2,"2016-08-30 21:25:55","2016-08-30 21:25:55"
2124,9500,1608,1608,11108,1,"2016-08-30 21:25:55","2016-08-30 21:25:55"
2125,6000,1367,1367,7367,1,"2016-08-30 21:25:55","2016-08-30 21:25:55"
2126,8500,1612,1612,10112,2,"2016-08-30 21:25:55","2016-08-30 21:25:55"
2127,4000,1379,1379,5379,1,"2016-08-30 21:25:55","2016-08-30 21:25:55"
2128,9500,1553,1553,11053,1,"2016-08-30 21:25:55","2016-08-30 21:25:55"
2129,8500,1550,0,8500,2,"2016-08-30 21:25:55","2016-08-30 21:25:55"
2130,8000,1448,0,8000,2,"2016-08-30 21:25:55","2016-08-30 21:25:55"
2131,4000,1202,1202,5202,1,"2016-08-30 21:25:55","2016-08-30 21:25:55"
2132,8000,1532,0,8000,2,"2016-08-30 21:25:55","2016-08-30 21:25:55"
2133,9000,1461,1461,10461,1,"2016-08-30 21:25:55","2016-08-30 21:25:55"
2134,9000,1619,0,9000,2,"2016-08-30 21:25:55","2016-08-30 21:25:55"
2135,7000,1430,1430,8430,2,"2016-08-30 21:25:55","2016-08-30 21:25:55"
2136,4000,1368,1368,5368,2,"2016-08-30 21:25:55","2016-08-30 21:25:55"
2137,8000,1583,0,8000,2,"2016-08-30 21:25:55","2016-08-30 21:25:55"
2138,8000,1495,0,8000,2,"2016-08-30 21:25:55","2016-08-30 21:25:55"
2139,7000,1354,1354,8354,1,"2016-08-30 21:25:55","2016-08-30 21:25:55"
2140,5000,1293,1293,6293,1,"2016-08-30 21:25:55","2016-08-30 21:25:55"
2141,4000,1245,1245,5245,1,"2016-08-30 21:25:55","2016-08-30 21:25:55"
2142,8000,1598,0,8000,2,"2016-08-30 21:25:55","2016-08-30 21:25:55"
2143,8900,1534,1534,10434,1,"2016-08-30 21:25:55","2016-08-30 21:25:55"
2144,8000,1466,0,8000,2,"2016-08-30 21:25:55","2016-08-30 21:25:55"
2145,9000,1510,0,9000,2,"2016-08-30 21:25:55","2016-08-30 21:25:55"
2146,8000,1460,0,8000,2,"2016-08-30 21:25:55","2016-08-30 21:25:55"
2147,4000,1237,1237,5237,1,"2016-08-30 21:25:55","2016-08-30 21:25:55"
2148,8000,1467,1467,9467,2,"2016-08-30 21:25:55","2016-08-30 21:25:55"
2149,7000,1452,1452,8452,2,"2016-08-30 21:25:55","2016-08-30 21:25:55"
2150,8000,1573,0,8000,2,"2016-08-30 21:25:55","2016-08-30 21:25:55"
2151,8000,1551,0,8000,2,"2016-08-30 21:25:55","2016-08-30 21:25:55"
2152,4000,1245,1245,5245,2,"2016-08-30 21:25:55","2016-08-30 21:25:55"
2153,8000,1472,1472,9472,1,"2016-08-30 21:25:55","2016-08-30 21:25:55"
2154,8500,1498,0,8500,2,"2016-08-30 21:25:55","2016-08-30 21:25:55"
2155,8500,1586,0,8500,2,"2016-08-30 21:25:55","2016-08-30 21:25:55"
2156,8000,1526,0,8000,2,"2016-08-30 21:25:55","2016-08-30 21:25:55"
2157,8000,1560,0,8000,2,"2016-08-30 21:25:55","2016-08-30 21:25:55"
2158,8000,1581,1581,9581,2,"2016-08-30 21:25:55","2016-08-30 21:25:55"
2159,4000,1314,1314,5314,1,"2016-08-30 21:25:55","2016-08-30 21:25:55"
2160,9900,1522,1522,11422,1,"2016-08-30 21:25:55","2016-08-30 21:25:55"
2161,8900,1496,0,8900,2,"2016-08-30 21:25:55","2016-08-30 21:25:55"
2162,8500,1456,0,8500,2,"2016-08-30 21:25:55","2016-08-30 21:25:55"
2163,8000,1492,0,8000,2,"2016-08-30 21:25:55","2016-08-30 21:25:55"
2164,8000,1437,1437,9437,1,"2016-08-30 21:25:55","2016-08-30 21:25:55"
2165,7000,1403,1403,8403,1,"2016-08-30 21:25:55","2016-08-30 21:25:55"
2166,5000,1402,1402,6402,1,"2016-08-30 21:25:55","2016-08-30 21:25:55"
2167,8900,1498,0,8900,2,"2016-08-30 21:25:55","2016-08-30 21:25:55"
2168,8500,1530,1530,10030,1,"2016-08-30 21:25:55","2016-08-30 21:25:55"
2169,8000,1406,0,8000,2,"2016-08-30 21:25:55","2016-08-30 21:25:55"
2170,4000,1339,1339,5339,1,"2016-08-30 21:25:55","2016-08-30 21:25:55"
2171,5000,1252,1252,6252,2,"2016-08-30 21:25:55","2016-08-30 21:25:55"
2172,8000,1477,1477,9477,2,"2016-08-30 21:25:55","2016-08-30 21:25:55"
2173,8500,1496,0,8500,2,"2016-08-30 21:25:55","2016-08-30 21:25:55"
2174,9900,1509,0,9900,2,"2016-08-30 21:25:55","2016-08-30 21:25:55"
2175,8000,1556,1556,9556,1,"2016-08-30 21:25:55","2016-08-30 21:25:55"
2176,6000,1469,1469,7469,1,"2016-08-30 21:25:55","2016-08-30 21:25:55"
2177,8500,1609,1609,10109,1,"2016-08-30 21:25:55","2016-08-30 21:25:55"
2178,8000,1528,1528,9528,1,"2016-08-30 21:25:55","2016-08-30 21:25:55"
2179,8500,1555,1555,10055,1,"2016-08-30 21:25:55","2016-08-30 21:25:55"
2180,8000,1513,0,8000,2,"2016-08-30 21:25:55","2016-08-30 21:25:55"
2181,5000,1404,1404,6404,2,"2016-08-30 21:25:55","2016-08-30 21:25:55"
2182,8900,1621,1621,10521,1,"2016-08-30 21:25:55","2016-08-30 21:25:55"
2183,8000,1494,0,8000,2,"2016-08-30 21:25:55","2016-08-30 21:25:55"
2184,4000,1347,1347,5347,1,"2016-08-30 21:25:55","2016-08-30 21:25:55"
2185,8000,1557,1557,9557,1,"2016-08-30 21:25:55","2016-08-30 21:25:55"
2186,4000,1362,1362,5362,1,"2016-08-30 21:25:55","2016-08-30 21:25:55"
2187,8500,1621,0,8500,2,"2016-08-30 21:25:55","2016-08-30 21:25:55"
2188,4000,1276,1276,5276,2,"2016-08-30 21:25:55","2016-08-30 21:25:55"
2189,4000,1288,1288,5288,1,"2016-08-30 21:25:55","2016-08-30 21:25:55"
2190,7000,1469,1469,8469,1,"2016-08-30 21:25:55","2016-08-30 21:25:55"
2191,8500,1552,0,8500,2,"2016-08-30 21:25:55","2016-08-30 21:25:55"
2192,5000,1305,1305,6305,1,"2016-08-30 21:25:55","2016-08-30 21:25:55"
2193,8000,1448,1448,9448,1,"2016-08-30 21:25:55","2016-08-30 21:25:55"
2194,7000,1504,1504,8504,2,"2016-08-30 21:25:55","2016-08-30 21:25:55"
2195,8500,1618,1618,10118,1,"2016-08-30 21:25:55","2016-08-30 21:25:55"
2196,8000,1552,0,8000,2,"2016-08-30 21:25:55","2016-08-30 21:25:55"
2197,4000,1224,1224,5224,2,"2016-08-30 21:25:55","2016-08-30 21:25:55"
2198,8500,1598,1598,10098,1,"2016-08-30 21:25:55","2016-08-30 21:25:55"
2199,5000,1444,1444,6444,1,"2016-08-30 21:25:55","2016-08-30 21:25:55"
2200,5000,1339,1339,6339,1,"2016-08-30 21:25:55","2016-08-30 21:25:55"
2201,9900,1685,1685,11585,1,"2016-08-30 21:25:55","2016-08-30 21:25:55"
2202,8900,1471,0,8900,2,"2016-08-30 21:25:55","2016-08-30 21:25:55"
2203,9000,1505,1505,10505,1,"2016-08-30 21:25:55","2016-08-30 21:25:55"
2204,8000,1587,0,8000,2,"2016-08-30 21:25:55","2016-08-30 21:25:55"
2205,7000,1480,1480,8480,1,"2016-08-30 21:25:55","2016-08-30 21:25:55"
2206,8000,1444,1444,9444,1,"2016-08-30 21:25:55","2016-08-30 21:25:55"
2207,5000,1394,1394,6394,1,"2016-08-30 21:25:55","2016-08-30 21:25:55"
2208,9500,1540,1540,11040,1,"2016-08-30 21:25:55","2016-08-30 21:25:55"
2209,6000,1435,1435,7435,1,"2016-08-30 21:25:55","2016-08-30 21:25:55"
2210,8500,1550,1550,10050,1,"2016-08-30 21:25:55","2016-08-30 21:25:55"
2211,4000,1344,1344,5344,1,"2016-08-30 21:25:55","2016-08-30 21:25:55"
2212,8000,1415,1415,9415,1,"2016-08-30 21:25:55","2016-08-30 21:25:55"
2213,8500,1559,1559,10059,1,"2016-08-30 21:25:55","2016-08-30 21:25:55"
2214,4000,1347,1347,5347,2,"2016-08-30 21:25:55","2016-08-30 21:25:55"
2215,5000,1256,1256,6256,1,"2016-08-30 21:25:55","2016-08-30 21:25:55"
2216,4000,1262,1262,5262,1,"2016-08-30 21:25:55","2016-08-30 21:25:55"
2217,8000,1530,1530,9530,1,"2016-08-30 21:25:55","2016-08-30 21:25:55"
2218,9900,1621,1621,11521,1,"2016-08-30 21:25:55","2016-08-30 21:25:55"
2219,8500,1541,0,8500,2,"2016-08-30 21:25:55","2016-08-30 21:25:55"
2220,4000,1388,1388,5388,1,"2016-08-30 21:25:55","2016-08-30 21:25:55"
2221,8500,1531,0,8500,2,"2016-08-30 21:25:55","2016-08-30 21:25:55"
2222,8500,1481,1481,9981,1,"2016-08-30 21:25:55","2016-08-30 21:25:55"
2223,6000,1494,1494,7494,2,"2016-08-30 21:25:55","2016-08-30 21:25:55"
2224,4000,1210,1210,5210,1,"2016-08-30 21:25:55","2016-08-30 21:25:55"
2225,8000,1441,0,8000,2,"2016-08-30 21:25:55","2016-08-30 21:25:55"
2226,9900,1537,1537,11437,1,"2016-08-30 21:25:55","2016-08-30 21:25:55"
2227,7000,1487,1487,8487,2,"2016-08-30 21:25:55","2016-08-30 21:25:55"
2228,4000,1254,1254,5254,1,"2016-08-30 21:25:55","2016-08-30 21:25:55"
2229,6000,1462,1462,7462,1,"2016-08-30 21:25:55","2016-08-30 21:25:55"
2230,4000,1244,1244,5244,2,"2016-08-30 21:25:55","2016-08-30 21:25:55"
2231,4000,1315,1315,5315,1,"2016-08-30 21:25:55","2016-08-30 21:25:55"
2232,7000,1408,1408,8408,2,"2016-08-30 21:25:55","2016-08-30 21:25:55"
2233,4000,1307,1307,5307,2,"2016-08-30 21:25:55","2016-08-30 21:25:55"
2234,8500,1499,0,8500,2,"2016-08-30 21:25:55","2016-08-30 21:25:55"
2235,8500,1440,1440,9940,1,"2016-08-30 21:25:55","2016-08-30 21:25:55"
2236,8900,1567,1567,10467,1,"2016-08-30 21:25:55","2016-08-30 21:25:55"
2237,6000,1326,1326,7326,2,"2016-08-30 21:25:55","2016-08-30 21:25:55"
2238,5000,1281,1281,6281,1,"2016-08-30 21:25:55","2016-08-30 21:25:55"
2239,5000,1413,1413,6413,1,"2016-08-30 21:25:55","2016-08-30 21:25:55"
2240,8000,1466,1466,9466,1,"2016-08-30 21:25:55","2016-08-30 21:25:55"
2241,9900,1584,1584,11484,1,"2016-08-30 21:25:55","2016-08-30 21:25:55"
2242,8500,1499,0,8500,2,"2016-08-30 21:25:55","2016-08-30 21:25:55"
2243,8000,1553,0,8000,2,"2016-08-30 21:25:55","2016-08-30 21:25:55"
2244,9900,1535,1535,11435,2,"2016-08-30 21:25:55","2016-08-30 21:25:55"
2245,9900,1501,0,9900,2,"2016-08-30 21:25:55","2016-08-30 21:25:55"
2246,9000,1554,1554,10554,1,"2016-08-30 21:25:55","2016-08-30 21:25:55"
2247,8000,1444,1444,9444,1,"2016-08-30 21:25:55","2016-08-30 21:25:55"
2248,9900,1522,1522,11422,1,"2016-08-30 21:25:55","2016-08-30 21:25:55"
2249,8500,1552,1552,10052,1,"2016-08-30 21:25:55","2016-08-30 21:25:55"
2250,7000,1473,1473,8473,1,"2016-08-30 21:25:55","2016-08-30 21:25:55"
2251,5000,1250,1250,6250,2,"2016-08-30 21:25:55","2016-08-30 21:25:55"
2252,8000,1595,0,8000,2,"2016-08-30 21:25:55","2016-08-30 21:25:55"
2253,9500,1569,1569,11069,2,"2016-08-30 21:25:55","2016-08-30 21:25:55"
2254,8900,1461,1461,10361,2,"2016-08-30 21:25:55","2016-08-30 21:25:55"
2255,8500,1489,1489,9989,1,"2016-08-30 21:25:55","2016-08-30 21:25:55"
2256,8000,1513,1513,9513,1,"2016-08-30 21:25:55","2016-08-30 21:25:55"
2257,8900,1548,1548,10448,1,"2016-08-30 21:25:55","2016-08-30 21:25:55"
2258,8900,1563,0,8900,2,"2016-08-30 21:25:55","2016-08-30 21:25:55"
2259,6000,1356,1356,7356,2,"2016-08-30 21:25:55","2016-08-30 21:25:55"
2260,8000,1480,0,8000,2,"2016-08-30 21:25:55","2016-08-30 21:25:55"
2261,9000,1632,1632,10632,1,"2016-08-30 21:25:55","2016-08-30 21:25:55"
2262,8500,1485,1485,9985,1,"2016-08-30 21:25:55","2016-08-30 21:25:55"
2263,9500,1497,1497,10997,1,"2016-08-30 21:25:55","2016-08-30 21:25:55"
2264,4000,1326,1326,5326,2,"2016-08-30 21:25:55","2016-08-30 21:25:55"
2265,7000,1413,1413,8413,2,"2016-08-30 21:25:55","2016-08-30 21:25:55"
2266,8900,1567,1567,10467,2,"2016-08-30 21:25:55","2016-08-30 21:25:55"
2267,4000,1264,1264,5264,2,"2016-08-30 21:25:55","2016-08-30 21:25:55"
2268,6000,1354,1354,7354,1,"2016-08-30 21:25:55","2016-08-30 21:25:55"
2269,8900,1504,0,8900,2,"2016-08-30 21:25:55","2016-08-30 21:25:55"
2270,8000,1513,0,8000,2,"2016-08-30 21:25:55","2016-08-30 21:25:55"
2271,8500,1563,0,8500,2,"2016-08-30 21:25:55","2016-08-30 21:25:55"
2272,8500,1525,1525,10025,1,"2016-08-30 21:25:55","2016-08-30 21:25:55"
2273,9900,1550,1550,11450,1,"2016-08-30 21:25:55","2016-08-30 21:25:55"
2274,5000,1448,1448,6448,1,"2016-08-30 21:25:55","2016-08-30 21:25:55"
2275,7000,1437,1437,8437,2,"2016-08-30 21:25:55","2016-08-30 21:25:55"
2276,8000,1473,0,8000,2,"2016-08-30 21:25:55","2016-08-30 21:25:55"
2277,4000,1308,1308,5308,1,"2016-08-30 21:25:55","2016-08-30 21:25:55"
2278,9000,1545,0,9000,2,"2016-08-30 21:25:55","2016-08-30 21:25:55"
2279,9000,1483,1483,10483,1,"2016-08-30 21:25:55","2016-08-30 21:25:55"
2280,8900,1622,1622,10522,2,"2016-08-30 21:25:55","2016-08-30 21:25:55"
2281,8900,1504,1504,10404,1,"2016-08-30 21:25:55","2016-08-30 21:25:55"
2282,9900,1561,1561,11461,1,"2016-08-30 21:25:55","2016-08-30 21:25:55"
2283,8900,1585,0,8900,2,"2016-08-30 21:25:55","2016-08-30 21:25:55"
2284,4000,1264,1264,5264,1,"2016-08-30 21:25:55","2016-08-30 21:25:55"
2285,9000,1576,1576,10576,1,"2016-08-30 21:25:55","2016-08-30 21:25:55"
2286,8000,1406,0,8000,2,"2016-08-30 21:25:55","2016-08-30 21:25:55"
2287,8000,1470,0,8000,2,"2016-08-30 21:25:55","2016-08-30 21:25:55"
2288,8900,1594,1594,10494,2,"2016-08-30 21:25:55","2016-08-30 21:25:55"
2289,8500,1559,0,8500,2,"2016-08-30 21:25:55","2016-08-30 21:25:55"
2290,8500,1510,1510,10010,1,"2016-08-30 21:25:55","2016-08-30 21:25:55"
2291,8900,1466,1466,10366,1,"2016-08-30 21:25:55","2016-08-30 21:25:55"
2292,8000,1507,0,8000,2,"2016-08-30 21:25:55","2016-08-30 21:25:55"
2293,5000,1330,1330,6330,1,"2016-08-30 21:25:55","2016-08-30 21:25:55"
2294,5000,1283,1283,6283,1,"2016-08-30 21:25:55","2016-08-30 21:25:55"
2295,5000,1319,1319,6319,2,"2016-08-30 21:25:55","2016-08-30 21:25:55"
2296,9000,1563,1563,10563,1,"2016-08-30 21:25:55","2016-08-30 21:25:55"
2297,7000,1502,1502,8502,1,"2016-08-30 21:25:55","2016-08-30 21:25:55"
2298,9900,1641,0,9900,2,"2016-08-30 21:25:55","2016-08-30 21:25:55"
2299,9900,1566,1566,11466,1,"2016-08-30 21:25:55","2016-08-30 21:25:55"
2300,6000,1471,1471,7471,1,"2016-08-30 21:25:55","2016-08-30 21:25:55"
2301,8000,1598,0,8000,2,"2016-08-30 21:25:55","2016-08-30 21:25:55"
2302,8000,1576,1576,9576,2,"2016-08-30 21:25:55","2016-08-30 21:25:55"
2303,7000,1510,1510,8510,1,"2016-08-30 21:25:55","2016-08-30 21:25:55"
2304,8000,1424,1424,9424,2,"2016-08-30 21:25:55","2016-08-30 21:25:55"
2305,6000,1424,1424,7424,2,"2016-08-30 21:25:55","2016-08-30 21:25:55"
2306,8900,1610,1610,10510,1,"2016-08-30 21:25:55","2016-08-30 21:25:55"
2307,6000,1488,1488,7488,2,"2016-08-30 21:25:55","2016-08-30 21:25:55"
2308,8000,1483,0,8000,2,"2016-08-30 21:25:55","2016-08-30 21:25:55"
2309,8000,1413,0,8000,2,"2016-08-30 21:25:55","2016-08-30 21:25:55"
2310,5000,1334,1334,6334,1,"2016-08-30 21:25:55","2016-08-30 21:25:55"
2311,8000,1503,1503,9503,1,"2016-08-30 21:25:55","2016-08-30 21:25:55"
2312,4000,1288,1288,5288,2,"2016-08-30 21:25:55","2016-08-30 21:25:55"
2313,5000,1399,1399,6399,1,"2016-08-30 21:25:55","2016-08-30 21:25:55"
2314,4000,1323,1323,5323,2,"2016-08-30 21:25:55","2016-08-30 21:25:55"
2315,9900,1581,1581,11481,2,"2016-08-30 21:25:55","2016-08-30 21:25:55"
2316,8500,1468,0,8500,2,"2016-08-30 21:25:55","2016-08-30 21:25:55"
2317,8500,1428,1428,9928,2,"2016-08-30 21:25:55","2016-08-30 21:25:55"
2318,5000,1355,1355,6355,1,"2016-08-30 21:25:55","2016-08-30 21:25:55"
2319,7000,1398,1398,8398,2,"2016-08-30 21:25:55","2016-08-30 21:25:55"
2320,8900,1468,1468,10368,1,"2016-08-30 21:25:55","2016-08-30 21:25:55"
2321,4000,1280,1280,5280,2,"2016-08-30 21:25:55","2016-08-30 21:25:55"
2322,9900,1510,0,9900,2,"2016-08-30 21:25:55","2016-08-30 21:25:55"
2323,9900,1691,1691,11591,1,"2016-08-30 21:25:55","2016-08-30 21:25:55"
2324,6000,1311,1311,7311,2,"2016-08-30 21:25:55","2016-08-30 21:25:55"
2325,8900,1614,0,8900,2,"2016-08-30 21:25:55","2016-08-30 21:25:55"
2326,8900,1600,1600,10500,1,"2016-08-30 21:25:55","2016-08-30 21:25:55"
2327,8900,1560,1560,10460,2,"2016-08-30 21:25:55","2016-08-30 21:25:55"
2328,8000,1559,1559,9559,2,"2016-08-30 21:25:55","2016-08-30 21:25:55"
2329,9000,1481,1481,10481,1,"2016-08-30 21:25:55","2016-08-30 21:25:55"
2330,8000,1579,1579,9579,2,"2016-08-30 21:25:55","2016-08-30 21:25:55"
2331,8900,1457,0,8900,2,"2016-08-30 21:25:55","2016-08-30 21:25:55"
2332,8500,1535,1535,10035,2,"2016-08-30 21:25:55","2016-08-30 21:25:55"
2333,8000,1520,0,8000,2,"2016-08-30 21:25:56","2016-08-30 21:25:56"
2334,9000,1455,1455,10455,1,"2016-08-30 21:25:56","2016-08-30 21:25:56"
2335,8000,1570,1570,9570,1,"2016-08-30 21:25:56","2016-08-30 21:25:56"
2336,8000,1486,0,8000,2,"2016-08-30 21:25:56","2016-08-30 21:25:56"
2337,5000,1384,1384,6384,1,"2016-08-30 21:25:56","2016-08-30 21:25:56"
2338,9500,1632,1632,11132,1,"2016-08-30 21:25:56","2016-08-30 21:25:56"
2339,8900,1479,0,8900,2,"2016-08-30 21:25:56","2016-08-30 21:25:56"
2340,8500,1562,0,8500,2,"2016-08-30 21:25:56","2016-08-30 21:25:56"
2341,8900,1450,1450,10350,1,"2016-08-30 21:25:56","2016-08-30 21:25:56"
2342,9000,1490,0,9000,2,"2016-08-30 21:25:56","2016-08-30 21:25:56"
2343,5000,1362,1362,6362,2,"2016-08-30 21:25:56","2016-08-30 21:25:56"
2344,8000,1546,0,8000,2,"2016-08-30 21:25:56","2016-08-30 21:25:56"
2345,4000,1291,1291,5291,1,"2016-08-30 21:25:56","2016-08-30 21:25:56"
2346,9500,1636,1636,11136,1,"2016-08-30 21:25:56","2016-08-30 21:25:56"
2347,4000,1380,1380,5380,1,"2016-08-30 21:25:56","2016-08-30 21:25:56"
2348,8000,1468,1468,9468,2,"2016-08-30 21:25:56","2016-08-30 21:25:56"
2349,8000,1547,1547,9547,1,"2016-08-30 21:25:56","2016-08-30 21:25:56"
2350,8900,1573,0,8900,2,"2016-08-30 21:25:56","2016-08-30 21:25:56"
2351,6000,1423,1423,7423,2,"2016-08-30 21:25:56","2016-08-30 21:25:56"
2352,4000,1222,1222,5222,1,"2016-08-30 21:25:56","2016-08-30 21:25:56"
2353,8000,1455,1455,9455,1,"2016-08-30 21:25:56","2016-08-30 21:25:56"
2354,8900,1558,0,8900,2,"2016-08-30 21:25:56","2016-08-30 21:25:56"
2355,8000,1550,0,8000,2,"2016-08-30 21:25:56","2016-08-30 21:25:56"
2356,8500,1517,0,8500,2,"2016-08-30 21:25:56","2016-08-30 21:25:56"
2357,4000,1328,1328,5328,1,"2016-08-30 21:25:56","2016-08-30 21:25:56"
2358,8000,1475,0,8000,2,"2016-08-30 21:25:56","2016-08-30 21:25:56"
2359,8000,1579,0,8000,2,"2016-08-30 21:25:56","2016-08-30 21:25:56"
2360,4000,1242,1242,5242,1,"2016-08-30 21:25:56","2016-08-30 21:25:56"
2361,9000,1567,1567,10567,1,"2016-08-30 21:25:56","2016-08-30 21:25:56"
2362,8000,1439,1439,9439,1,"2016-08-30 21:25:56","2016-08-30 21:25:56"
2363,8000,1424,1424,9424,1,"2016-08-30 21:25:56","2016-08-30 21:25:56"
2364,8500,1610,0,8500,2,"2016-08-30 21:25:56","2016-08-30 21:25:56"
2365,6000,1433,1433,7433,2,"2016-08-30 21:25:56","2016-08-30 21:25:56"
2366,8000,1485,0,8000,2,"2016-08-30 21:25:56","2016-08-30 21:25:56"
2367,8000,1551,1551,9551,2,"2016-08-30 21:25:56","2016-08-30 21:25:56"
2368,8000,1428,1428,9428,2,"2016-08-30 21:25:56","2016-08-30 21:25:56"
2369,9500,1491,1491,10991,1,"2016-08-30 21:25:56","2016-08-30 21:25:56"
2370,8000,1582,0,8000,2,"2016-08-30 21:25:56","2016-08-30 21:25:56"
2371,8900,1482,0,8900,2,"2016-08-30 21:25:56","2016-08-30 21:25:56"
2372,8000,1540,0,8000,2,"2016-08-30 21:25:56","2016-08-30 21:25:56"
2373,8500,1538,0,8500,2,"2016-08-30 21:25:56","2016-08-30 21:25:56"
2374,9900,1651,1651,11551,1,"2016-08-30 21:25:56","2016-08-30 21:25:56"
2375,4000,1267,1267,5267,2,"2016-08-30 21:25:56","2016-08-30 21:25:56"
2376,8900,1535,1535,10435,1,"2016-08-30 21:25:56","2016-08-30 21:25:56"
2377,9500,1518,1518,11018,1,"2016-08-30 21:25:56","2016-08-30 21:25:56"
2378,8500,1450,1450,9950,1,"2016-08-30 21:25:56","2016-08-30 21:25:56"
2379,8500,1596,0,8500,2,"2016-08-30 21:25:56","2016-08-30 21:25:56"
2380,8000,1459,0,8000,2,"2016-08-30 21:25:56","2016-08-30 21:25:56"
2381,8000,1502,0,8000,2,"2016-08-30 21:25:56","2016-08-30 21:25:56"
2382,4000,1205,1205,5205,1,"2016-08-30 21:25:56","2016-08-30 21:25:56"
2383,4000,1368,1368,5368,1,"2016-08-30 21:25:56","2016-08-30 21:25:56"
2384,5000,1349,1349,6349,2,"2016-08-30 21:25:56","2016-08-30 21:25:56"
2385,5000,1285,1285,6285,1,"2016-08-30 21:25:56","2016-08-30 21:25:56"
2386,6000,1354,1354,7354,1,"2016-08-30 21:25:56","2016-08-30 21:25:56"
2387,8900,1604,1604,10504,2,"2016-08-30 21:25:56","2016-08-30 21:25:56"
2388,4000,1313,1313,5313,2,"2016-08-30 21:25:56","2016-08-30 21:25:56"
2389,5000,1301,1301,6301,1,"2016-08-30 21:25:56","2016-08-30 21:25:56"
2390,8000,1416,1416,9416,2,"2016-08-30 21:25:56","2016-08-30 21:25:56"
2391,9000,1554,1554,10554,1,"2016-08-30 21:25:56","2016-08-30 21:25:56"
2392,8500,1507,1507,10007,1,"2016-08-30 21:25:56","2016-08-30 21:25:56"
2393,6000,1396,1396,7396,1,"2016-08-30 21:25:56","2016-08-30 21:25:56"
2394,8500,1608,0,8500,2,"2016-08-30 21:25:56","2016-08-30 21:25:56"
2395,8000,1500,1500,9500,1,"2016-08-30 21:25:56","2016-08-30 21:25:56"
2396,8500,1439,1439,9939,1,"2016-08-30 21:25:56","2016-08-30 21:25:56"
2397,5000,1349,1349,6349,1,"2016-08-30 21:25:56","2016-08-30 21:25:56"
2398,8500,1556,1556,10056,2,"2016-08-30 21:25:56","2016-08-30 21:25:56"
2399,4000,1393,1393,5393,1,"2016-08-30 21:25:56","2016-08-30 21:25:56"
2400,8000,1555,0,8000,2,"2016-08-30 21:25:56","2016-08-30 21:25:56"
2401,8000,1531,0,8000,2,"2016-08-30 21:25:56","2016-08-30 21:25:56"
2402,5000,1320,1320,6320,1,"2016-08-30 21:25:56","2016-08-30 21:25:56"
2403,8000,1536,0,8000,2,"2016-08-30 21:25:56","2016-08-30 21:25:56"
2404,8900,1619,1619,10519,2,"2016-08-30 21:25:56","2016-08-30 21:25:56"
2405,8900,1507,1507,10407,2,"2016-08-30 21:25:56","2016-08-30 21:25:56"
2406,8000,1563,0,8000,2,"2016-08-30 21:25:56","2016-08-30 21:25:56"
2407,4000,1349,1349,5349,2,"2016-08-30 21:25:56","2016-08-30 21:25:56"
2408,8000,1442,0,8000,2,"2016-08-30 21:25:56","2016-08-30 21:25:56"
2409,8000,1491,0,8000,2,"2016-08-30 21:25:56","2016-08-30 21:25:56"
2410,8900,1628,1628,10528,1,"2016-08-30 21:25:56","2016-08-30 21:25:56"
2411,9500,1655,1655,11155,1,"2016-08-30 21:25:56","2016-08-30 21:25:56"
2412,8900,1640,0,8900,2,"2016-08-30 21:25:56","2016-08-30 21:25:56"
2413,9500,1674,1674,11174,1,"2016-08-30 21:25:56","2016-08-30 21:25:56"
2414,9900,1604,1604,11504,1,"2016-08-30 21:25:56","2016-08-30 21:25:56"
2415,8000,1459,1459,9459,2,"2016-08-30 21:25:56","2016-08-30 21:25:56"
2416,8000,1512,1512,9512,1,"2016-08-30 21:25:56","2016-08-30 21:25:56"
2417,7000,1412,1412,8412,1,"2016-08-30 21:25:56","2016-08-30 21:25:56"
2418,8900,1542,0,8900,2,"2016-08-30 21:25:56","2016-08-30 21:25:56"
2419,5000,1366,1366,6366,1,"2016-08-30 21:25:56","2016-08-30 21:25:56"
2420,8000,1546,1546,9546,2,"2016-08-30 21:25:56","2016-08-30 21:25:56"
2421,8900,1458,0,8900,2,"2016-08-30 21:25:56","2016-08-30 21:25:56"
2422,8500,1618,0,8500,2,"2016-08-30 21:25:56","2016-08-30 21:25:56"
2423,9900,1660,1660,11560,1,"2016-08-30 21:25:56","2016-08-30 21:25:56"
2424,9000,1558,1558,10558,1,"2016-08-30 21:25:56","2016-08-30 21:25:56"
2425,8900,1531,1531,10431,2,"2016-08-30 21:25:56","2016-08-30 21:25:56"
2426,8000,1560,0,8000,2,"2016-08-30 21:25:56","2016-08-30 21:25:56"
2427,9900,1693,1693,11593,1,"2016-08-30 21:25:56","2016-08-30 21:25:56"
2428,4000,1301,1301,5301,1,"2016-08-30 21:25:56","2016-08-30 21:25:56"
2429,5000,1299,1299,6299,1,"2016-08-30 21:25:56","2016-08-30 21:25:56"
2430,9900,1559,0,9900,2,"2016-08-30 21:25:56","2016-08-30 21:25:56"
2431,8000,1486,1486,9486,1,"2016-08-30 21:25:56","2016-08-30 21:25:56"
2432,9900,1630,1630,11530,1,"2016-08-30 21:25:56","2016-08-30 21:25:56"
2433,9500,1673,0,9500,2,"2016-08-30 21:25:56","2016-08-30 21:25:56"
2434,7000,1441,1441,8441,1,"2016-08-30 21:25:56","2016-08-30 21:25:56"
2435,5000,1374,1374,6374,1,"2016-08-30 21:25:56","2016-08-30 21:25:56"
2436,8000,1513,0,8000,2,"2016-08-30 21:25:56","2016-08-30 21:25:56"
2437,8000,1451,1451,9451,2,"2016-08-30 21:25:56","2016-08-30 21:25:56"
2438,5000,1303,1303,6303,1,"2016-08-30 21:25:56","2016-08-30 21:25:56"
2439,9900,1641,1641,11541,1,"2016-08-30 21:25:56","2016-08-30 21:25:56"
2440,8000,1412,1412,9412,2,"2016-08-30 21:25:56","2016-08-30 21:25:56"
2441,8500,1481,0,8500,2,"2016-08-30 21:25:56","2016-08-30 21:25:56"
2442,9500,1594,1594,11094,1,"2016-08-30 21:25:56","2016-08-30 21:25:56"
2443,8000,1580,1580,9580,2,"2016-08-30 21:25:56","2016-08-30 21:25:56"
2444,5000,1379,1379,6379,2,"2016-08-30 21:25:56","2016-08-30 21:25:56"
2445,9500,1550,1550,11050,1,"2016-08-30 21:25:56","2016-08-30 21:25:56"
2446,5000,1444,1444,6444,1,"2016-08-30 21:25:56","2016-08-30 21:25:56"
2447,4000,1294,1294,5294,2,"2016-08-30 21:25:56","2016-08-30 21:25:56"
2448,8000,1450,0,8000,2,"2016-08-30 21:25:56","2016-08-30 21:25:56"
2449,8900,1599,0,8900,2,"2016-08-30 21:25:56","2016-08-30 21:25:56"
2450,8900,1567,0,8900,2,"2016-08-30 21:25:56","2016-08-30 21:25:56"
2451,9500,1540,1540,11040,1,"2016-08-30 21:25:56","2016-08-30 21:25:56"
2452,7000,1484,1484,8484,2,"2016-08-30 21:25:56","2016-08-30 21:25:56"
2453,8000,1442,0,8000,2,"2016-08-30 21:25:56","2016-08-30 21:25:56"
2454,8000,1509,0,8000,2,"2016-08-30 21:25:56","2016-08-30 21:25:56"
2455,5000,1419,1419,6419,1,"2016-08-30 21:25:56","2016-08-30 21:25:56"
2456,8900,1602,1602,10502,1,"2016-08-30 21:25:56","2016-08-30 21:25:56"
2457,9900,1593,1593,11493,1,"2016-08-30 21:25:56","2016-08-30 21:25:56"
2458,9900,1605,1605,11505,1,"2016-08-30 21:25:56","2016-08-30 21:25:56"
2459,8900,1508,0,8900,2,"2016-08-30 21:25:56","2016-08-30 21:25:56"
2460,8000,1457,1457,9457,1,"2016-08-30 21:25:56","2016-08-30 21:25:56"
2461,8000,1598,0,8000,2,"2016-08-30 21:25:56","2016-08-30 21:25:56"
2462,8000,1475,0,8000,2,"2016-08-30 21:25:56","2016-08-30 21:25:56"
2463,8000,1595,0,8000,2,"2016-08-30 21:25:56","2016-08-30 21:25:56"
2464,4000,1259,1259,5259,1,"2016-08-30 21:25:56","2016-08-30 21:25:56"
2465,9900,1646,0,9900,2,"2016-08-30 21:25:56","2016-08-30 21:25:56"
2466,7000,1445,1445,8445,1,"2016-08-30 21:25:56","2016-08-30 21:25:56"
2467,9500,1542,1542,11042,1,"2016-08-30 21:25:56","2016-08-30 21:25:56"
2468,8000,1522,0,8000,2,"2016-08-30 21:25:56","2016-08-30 21:25:56"
2469,8000,1457,1457,9457,1,"2016-08-30 21:25:56","2016-08-30 21:25:56"
2470,8000,1585,1585,9585,1,"2016-08-30 21:25:56","2016-08-30 21:25:56"
2471,5000,1321,1321,6321,1,"2016-08-30 21:25:56","2016-08-30 21:25:56"
2472,8500,1441,1441,9941,1,"2016-08-30 21:25:56","2016-08-30 21:25:56"
2473,8500,1512,0,8500,2,"2016-08-30 21:25:56","2016-08-30 21:25:56"
2474,8000,1470,1470,9470,2,"2016-08-30 21:25:56","2016-08-30 21:25:56"
2475,8000,1498,0,8000,2,"2016-08-30 21:25:56","2016-08-30 21:25:56"
2476,8500,1505,0,8500,2,"2016-08-30 21:25:56","2016-08-30 21:25:56"
2477,7000,1376,1376,8376,1,"2016-08-30 21:25:56","2016-08-30 21:25:56"
2478,8000,1522,1522,9522,1,"2016-08-30 21:25:56","2016-08-30 21:25:56"
2479,7000,1488,1488,8488,1,"2016-08-30 21:25:56","2016-08-30 21:25:56"
2480,4000,1208,1208,5208,1,"2016-08-30 21:25:56","2016-08-30 21:25:56"
2481,8000,1486,0,8000,2,"2016-08-30 21:25:56","2016-08-30 21:25:56"
2482,7000,1458,1458,8458,2,"2016-08-30 21:25:56","2016-08-30 21:25:56"
2483,8000,1515,0,8000,2,"2016-08-30 21:25:56","2016-08-30 21:25:56"
2484,9000,1627,1627,10627,1,"2016-08-30 21:25:56","2016-08-30 21:25:56"
2485,8000,1452,1452,9452,1,"2016-08-30 21:25:56","2016-08-30 21:25:56"
2486,8900,1460,1460,10360,2,"2016-08-30 21:25:56","2016-08-30 21:25:56"
2487,8000,1432,0,8000,2,"2016-08-30 21:25:56","2016-08-30 21:25:56"
2488,8000,1594,0,8000,2,"2016-08-30 21:25:56","2016-08-30 21:25:56"
2489,9000,1478,1478,10478,1,"2016-08-30 21:25:56","2016-08-30 21:25:56"
2490,8000,1493,0,8000,2,"2016-08-30 21:25:56","2016-08-30 21:25:56"
2491,8000,1546,0,8000,2,"2016-08-30 21:25:56","2016-08-30 21:25:56"
2492,8000,1590,1590,9590,1,"2016-08-30 21:25:56","2016-08-30 21:25:56"
2493,9000,1479,1479,10479,1,"2016-08-30 21:25:56","2016-08-30 21:25:56"
2494,5000,1357,1357,6357,1,"2016-08-30 21:25:56","2016-08-30 21:25:56"
2495,4000,1392,1392,5392,1,"2016-08-30 21:25:56","2016-08-30 21:25:56"
2496,8000,1409,1409,9409,2,"2016-08-30 21:25:56","2016-08-30 21:25:56"
2497,8000,1429,0,8000,2,"2016-08-30 21:25:56","2016-08-30 21:25:56"
2498,8500,1511,0,8500,2,"2016-08-30 21:25:56","2016-08-30 21:25:56"
2499,8000,1414,1414,9414,1,"2016-08-30 21:25:56","2016-08-30 21:25:56"
2500,4000,1231,1231,5231,1,"2016-08-30 21:25:56","2016-08-30 21:25:56"
2501,5000,1276,1276,6276,1,"2016-08-30 21:25:56","2016-08-30 21:25:56"
2502,8900,1642,0,8900,2,"2016-08-30 21:25:56","2016-08-30 21:25:56"
2503,8900,1599,0,8900,2,"2016-08-30 21:25:56","2016-08-30 21:25:56"
2504,8000,1422,1422,9422,1,"2016-08-30 21:25:56","2016-08-30 21:25:56"
2505,8000,1507,1507,9507,1,"2016-08-30 21:25:56","2016-08-30 21:25:56"
2506,5000,1307,1307,6307,2,"2016-08-30 21:25:56","2016-08-30 21:25:56"
2507,8000,1591,0,8000,2,"2016-08-30 21:25:56","2016-08-30 21:25:56"
2508,4000,1372,1372,5372,1,"2016-08-30 21:25:56","2016-08-30 21:25:56"
2509,8000,1501,0,8000,2,"2016-08-30 21:25:56","2016-08-30 21:25:56"
2510,8500,1488,0,8500,2,"2016-08-30 21:25:56","2016-08-30 21:25:56"
2511,8000,1535,0,8000,2,"2016-08-30 21:25:56","2016-08-30 21:25:56"
2512,8000,1596,1596,9596,2,"2016-08-30 21:25:56","2016-08-30 21:25:56"
2513,8500,1624,1624,10124,1,"2016-08-30 21:25:56","2016-08-30 21:25:56"
2514,8500,1573,0,8500,2,"2016-08-30 21:25:56","2016-08-30 21:25:56"
2515,8000,1595,1595,9595,1,"2016-08-30 21:25:56","2016-08-30 21:25:56"
2516,8000,1585,1585,9585,2,"2016-08-30 21:25:56","2016-08-30 21:25:56"
2517,9500,1494,0,9500,2,"2016-08-30 21:25:56","2016-08-30 21:25:56"
2518,4000,1216,1216,5216,2,"2016-08-30 21:25:56","2016-08-30 21:25:56"
2519,8000,1546,1546,9546,1,"2016-08-30 21:25:56","2016-08-30 21:25:56"
2520,8000,1545,0,8000,2,"2016-08-30 21:25:56","2016-08-30 21:25:56"
2521,8900,1447,0,8900,2,"2016-08-30 21:25:56","2016-08-30 21:25:56"
2522,8000,1582,0,8000,2,"2016-08-30 21:25:56","2016-08-30 21:25:56"
2523,8900,1634,0,8900,2,"2016-08-30 21:25:56","2016-08-30 21:25:56"
2524,8000,1581,0,8000,2,"2016-08-30 21:25:56","2016-08-30 21:25:56"
2525,8000,1445,1445,9445,1,"2016-08-30 21:25:56","2016-08-30 21:25:56"
2526,8500,1522,0,8500,2,"2016-08-30 21:25:56","2016-08-30 21:25:56"
2527,5000,1325,1325,6325,1,"2016-08-30 21:25:56","2016-08-30 21:25:56"
2528,9000,1509,1509,10509,1,"2016-08-30 21:25:56","2016-08-30 21:25:56"
2529,8000,1543,0,8000,2,"2016-08-30 21:25:56","2016-08-30 21:25:56"
2530,9900,1681,1681,11581,1,"2016-08-30 21:25:56","2016-08-30 21:25:56"
2531,9900,1606,1606,11506,1,"2016-08-30 21:25:56","2016-08-30 21:25:56"
2532,8500,1623,0,8500,2,"2016-08-30 21:25:56","2016-08-30 21:25:56"
2533,8000,1550,1550,9550,1,"2016-08-30 21:25:56","2016-08-30 21:25:56"
2534,8500,1493,0,8500,2,"2016-08-30 21:25:56","2016-08-30 21:25:56"
2535,5000,1383,1383,6383,1,"2016-08-30 21:25:56","2016-08-30 21:25:56"
2536,8000,1440,1440,9440,1,"2016-08-30 21:25:56","2016-08-30 21:25:56"
2537,8500,1594,0,8500,2,"2016-08-30 21:25:56","2016-08-30 21:25:56"
2538,8500,1620,1620,10120,1,"2016-08-30 21:25:56","2016-08-30 21:25:56"
2539,8000,1470,0,8000,2,"2016-08-30 21:25:56","2016-08-30 21:25:56"
2540,5000,1385,1385,6385,1,"2016-08-30 21:25:56","2016-08-30 21:25:56"
2541,9900,1678,1678,11578,1,"2016-08-30 21:25:56","2016-08-30 21:25:56"
2542,8500,1622,0,8500,2,"2016-08-30 21:25:56","2016-08-30 21:25:56"
2543,4000,1266,1266,5266,1,"2016-08-30 21:25:56","2016-08-30 21:25:56"
2544,9000,1521,0,9000,2,"2016-08-30 21:25:56","2016-08-30 21:25:56"
2545,5000,1337,1337,6337,1,"2016-08-30 21:25:56","2016-08-30 21:25:56"
2546,8000,1557,1557,9557,1,"2016-08-30 21:25:56","2016-08-30 21:25:56"
2547,8900,1493,1493,10393,1,"2016-08-30 21:25:56","2016-08-30 21:25:56"
2548,8900,1514,0,8900,2,"2016-08-30 21:25:56","2016-08-30 21:25:56"
2549,8000,1522,1522,9522,1,"2016-08-30 21:25:56","2016-08-30 21:25:56"
2550,8000,1511,0,8000,2,"2016-08-30 21:25:56","2016-08-30 21:25:56"
2551,8500,1518,1518,10018,2,"2016-08-30 21:25:56","2016-08-30 21:25:56"
2552,9500,1536,0,9500,2,"2016-08-30 21:25:56","2016-08-30 21:25:56"
2553,6000,1340,1340,7340,1,"2016-08-30 21:25:56","2016-08-30 21:25:56"
2554,7000,1490,1490,8490,2,"2016-08-30 21:25:56","2016-08-30 21:25:56"
2555,8000,1595,1595,9595,2,"2016-08-30 21:25:56","2016-08-30 21:25:56"
2556,9500,1554,1554,11054,1,"2016-08-30 21:25:56","2016-08-30 21:25:56"
2557,8900,1611,1611,10511,1,"2016-08-30 21:25:56","2016-08-30 21:25:56"
2558,9900,1596,1596,11496,1,"2016-08-30 21:25:56","2016-08-30 21:25:56"
2559,8900,1550,0,8900,2,"2016-08-30 21:25:56","2016-08-30 21:25:56"
2560,7000,1401,1401,8401,1,"2016-08-30 21:25:56","2016-08-30 21:25:56"
2561,8900,1545,1545,10445,2,"2016-08-30 21:25:56","2016-08-30 21:25:56"
2562,8000,1559,1559,9559,2,"2016-08-30 21:25:56","2016-08-30 21:25:56"
2563,8500,1426,0,8500,2,"2016-08-30 21:25:56","2016-08-30 21:25:56"
2564,9500,1528,1528,11028,1,"2016-08-30 21:25:56","2016-08-30 21:25:56"
2565,5000,1304,1304,6304,1,"2016-08-30 21:25:56","2016-08-30 21:25:56"
2566,8000,1596,1596,9596,1,"2016-08-30 21:25:56","2016-08-30 21:25:56"
2567,8900,1580,0,8900,2,"2016-08-30 21:25:56","2016-08-30 21:25:56"
2568,5000,1391,1391,6391,1,"2016-08-30 21:25:56","2016-08-30 21:25:56"
2569,4000,1357,1357,5357,1,"2016-08-30 21:25:56","2016-08-30 21:25:56"
2570,9900,1633,1633,11533,1,"2016-08-30 21:25:56","2016-08-30 21:25:56"
2571,4000,1287,1287,5287,2,"2016-08-30 21:25:56","2016-08-30 21:25:56"
2572,8900,1587,0,8900,2,"2016-08-30 21:25:56","2016-08-30 21:25:56"
2573,8900,1600,1600,10500,2,"2016-08-30 21:25:56","2016-08-30 21:25:56"
2574,8900,1572,1572,10472,1,"2016-08-30 21:25:56","2016-08-30 21:25:56"
2575,5000,1423,1423,6423,1,"2016-08-30 21:25:56","2016-08-30 21:25:56"
2576,8900,1462,0,8900,2,"2016-08-30 21:25:56","2016-08-30 21:25:56"
2577,8000,1577,0,8000,2,"2016-08-30 21:25:56","2016-08-30 21:25:56"
2578,4000,1233,1233,5233,2,"2016-08-30 21:25:56","2016-08-30 21:25:56"
2579,8000,1485,1485,9485,1,"2016-08-30 21:25:56","2016-08-30 21:25:56"
2580,9900,1683,1683,11583,1,"2016-08-30 21:25:56","2016-08-30 21:25:56"
2581,8000,1402,1402,9402,1,"2016-08-30 21:25:56","2016-08-30 21:25:56"
2582,4000,1323,1323,5323,1,"2016-08-30 21:25:56","2016-08-30 21:25:56"
2583,8000,1410,0,8000,2,"2016-08-30 21:25:56","2016-08-30 21:25:56"
2584,8000,1510,0,8000,2,"2016-08-30 21:25:56","2016-08-30 21:25:56"
2585,8500,1521,1521,10021,1,"2016-08-30 21:25:56","2016-08-30 21:25:56"
2586,8000,1449,0,8000,2,"2016-08-30 21:25:56","2016-08-30 21:25:56"
2587,8900,1462,1462,10362,1,"2016-08-30 21:25:56","2016-08-30 21:25:56"
2588,9000,1623,1623,10623,1,"2016-08-30 21:25:56","2016-08-30 21:25:56"
2589,8900,1538,0,8900,2,"2016-08-30 21:25:56","2016-08-30 21:25:56"
2590,8900,1575,0,8900,2,"2016-08-30 21:25:56","2016-08-30 21:25:56"
2591,8500,1522,1522,10022,2,"2016-08-30 21:25:56","2016-08-30 21:25:56"
2592,8000,1400,1400,9400,1,"2016-08-30 21:25:56","2016-08-30 21:25:56"
2593,9900,1671,1671,11571,1,"2016-08-30 21:25:56","2016-08-30 21:25:56"
2594,9900,1584,1584,11484,1,"2016-08-30 21:25:56","2016-08-30 21:25:56"
2595,5000,1393,1393,6393,2,"2016-08-30 21:25:56","2016-08-30 21:25:56"
2596,8500,1597,0,8500,2,"2016-08-30 21:25:56","2016-08-30 21:25:56"
2597,9900,1621,0,9900,2,"2016-08-30 21:25:56","2016-08-30 21:25:56"
2598,9500,1639,1639,11139,1,"2016-08-30 21:25:56","2016-08-30 21:25:56"
2599,8900,1530,0,8900,2,"2016-08-30 21:25:56","2016-08-30 21:25:56"
2600,9900,1653,1653,11553,1,"2016-08-30 21:25:56","2016-08-30 21:25:56"
2601,8500,1527,1527,10027,1,"2016-08-30 21:25:56","2016-08-30 21:25:56"
2602,9500,1571,1571,11071,1,"2016-08-30 21:25:56","2016-08-30 21:25:56"
2603,4000,1279,1279,5279,2,"2016-08-30 21:25:56","2016-08-30 21:25:56"
2604,8000,1570,0,8000,2,"2016-08-30 21:25:56","2016-08-30 21:25:56"
2605,9500,1525,1525,11025,1,"2016-08-30 21:25:56","2016-08-30 21:25:56"
2606,4000,1228,1228,5228,1,"2016-08-30 21:25:56","2016-08-30 21:25:56"
2607,5000,1432,1432,6432,2,"2016-08-30 21:25:56","2016-08-30 21:25:56"
2608,8000,1521,1521,9521,1,"2016-08-30 21:25:56","2016-08-30 21:25:56"
2609,8000,1428,1428,9428,1,"2016-08-30 21:25:56","2016-08-30 21:25:56"
2610,8900,1492,0,8900,2,"2016-08-30 21:25:56","2016-08-30 21:25:56"
2611,8000,1589,1589,9589,1,"2016-08-30 21:25:56","2016-08-30 21:25:56"
2612,8500,1444,1444,9944,2,"2016-08-30 21:25:56","2016-08-30 21:25:56"
2613,4000,1235,1235,5235,1,"2016-08-30 21:25:56","2016-08-30 21:25:56"
2614,9900,1548,0,9900,2,"2016-08-30 21:25:56","2016-08-30 21:25:56"
2615,8000,1506,0,8000,2,"2016-08-30 21:25:56","2016-08-30 21:25:56"
2616,8500,1580,0,8500,2,"2016-08-30 21:25:56","2016-08-30 21:25:56"
2617,9000,1489,0,9000,2,"2016-08-30 21:25:56","2016-08-30 21:25:56"
2618,8000,1472,0,8000,2,"2016-08-30 21:25:56","2016-08-30 21:25:56"
2619,8900,1593,0,8900,2,"2016-08-30 21:25:56","2016-08-30 21:25:56"
2620,5000,1356,1356,6356,1,"2016-08-30 21:25:56","2016-08-30 21:25:56"
2621,8000,1440,1440,9440,2,"2016-08-30 21:25:56","2016-08-30 21:25:56"
2622,7000,1439,1439,8439,1,"2016-08-30 21:25:56","2016-08-30 21:25:56"
2623,8000,1443,0,8000,2,"2016-08-30 21:25:56","2016-08-30 21:25:56"
2624,9900,1625,1625,11525,1,"2016-08-30 21:25:56","2016-08-30 21:25:56"
2625,8500,1605,1605,10105,2,"2016-08-30 21:25:56","2016-08-30 21:25:56"
2626,8000,1497,1497,9497,1,"2016-08-30 21:25:56","2016-08-30 21:25:56"
2627,8500,1495,0,8500,2,"2016-08-30 21:25:56","2016-08-30 21:25:56"
2628,5000,1402,1402,6402,1,"2016-08-30 21:25:56","2016-08-30 21:25:56"
2629,8000,1540,1540,9540,1,"2016-08-30 21:25:56","2016-08-30 21:25:56"
2630,8000,1542,1542,9542,1,"2016-08-30 21:25:56","2016-08-30 21:25:56"
2631,8000,1597,1597,9597,1,"2016-08-30 21:25:56","2016-08-30 21:25:56"
2632,4000,1344,1344,5344,2,"2016-08-30 21:25:56","2016-08-30 21:25:56"
2633,5000,1394,1394,6394,1,"2016-08-30 21:25:56","2016-08-30 21:25:56"
2634,8000,1409,1409,9409,2,"2016-08-30 21:25:56","2016-08-30 21:25:56"
2635,8000,1558,1558,9558,2,"2016-08-30 21:25:56","2016-08-30 21:25:56"
2636,8000,1445,0,8000,2,"2016-08-30 21:25:56","2016-08-30 21:25:56"
2637,8000,1596,0,8000,2,"2016-08-30 21:25:56","2016-08-30 21:25:56"
2638,8500,1527,1527,10027,1,"2016-08-30 21:25:56","2016-08-30 21:25:56"
2639,5000,1261,1261,6261,2,"2016-08-30 21:25:56","2016-08-30 21:25:56"
2640,8000,1403,0,8000,2,"2016-08-30 21:25:56","2016-08-30 21:25:56"
2641,6000,1300,1300,7300,1,"2016-08-30 21:25:56","2016-08-30 21:25:56"
2642,9500,1543,1543,11043,1,"2016-08-30 21:25:57","2016-08-30 21:25:57"
2643,8000,1575,1575,9575,1,"2016-08-30 21:25:57","2016-08-30 21:25:57"
2644,5000,1414,1414,6414,2,"2016-08-30 21:25:57","2016-08-30 21:25:57"
2645,8000,1552,0,8000,2,"2016-08-30 21:25:57","2016-08-30 21:25:57"
2646,8000,1596,1596,9596,1,"2016-08-30 21:25:57","2016-08-30 21:25:57"
2647,4000,1264,1264,5264,1,"2016-08-30 21:25:57","2016-08-30 21:25:57"
2648,4000,1384,1384,5384,1,"2016-08-30 21:25:57","2016-08-30 21:25:57"
2649,5000,1298,1298,6298,1,"2016-08-30 21:25:57","2016-08-30 21:25:57"
2650,8500,1558,1558,10058,2,"2016-08-30 21:25:57","2016-08-30 21:25:57"
2651,8500,1572,0,8500,2,"2016-08-30 21:25:57","2016-08-30 21:25:57"
2652,8000,1534,1534,9534,1,"2016-08-30 21:25:57","2016-08-30 21:25:57"
2653,8000,1468,0,8000,2,"2016-08-30 21:25:57","2016-08-30 21:25:57"
2654,4000,1232,1232,5232,1,"2016-08-30 21:25:57","2016-08-30 21:25:57"
2655,8000,1458,1458,9458,1,"2016-08-30 21:25:57","2016-08-30 21:25:57"
2656,8000,1407,0,8000,2,"2016-08-30 21:25:57","2016-08-30 21:25:57"
2657,8500,1570,0,8500,2,"2016-08-30 21:25:57","2016-08-30 21:25:57"
2658,9000,1562,0,9000,2,"2016-08-30 21:25:57","2016-08-30 21:25:57"
2659,8900,1602,1602,10502,2,"2016-08-30 21:25:57","2016-08-30 21:25:57"
2660,4000,1376,1376,5376,1,"2016-08-30 21:25:57","2016-08-30 21:25:57"
2661,5000,1342,1342,6342,1,"2016-08-30 21:25:57","2016-08-30 21:25:57"
2662,5000,1429,1429,6429,1,"2016-08-30 21:25:57","2016-08-30 21:25:57"
2663,6000,1309,1309,7309,2,"2016-08-30 21:25:57","2016-08-30 21:25:57"
2664,9900,1632,1632,11532,1,"2016-08-30 21:25:57","2016-08-30 21:25:57"
2665,5000,1424,1424,6424,1,"2016-08-30 21:25:57","2016-08-30 21:25:57"
2666,8000,1519,1519,9519,1,"2016-08-30 21:25:57","2016-08-30 21:25:57"
2667,8000,1597,0,8000,2,"2016-08-30 21:25:57","2016-08-30 21:25:57"
2668,4000,1379,1379,5379,1,"2016-08-30 21:25:57","2016-08-30 21:25:57"
2669,8000,1533,0,8000,2,"2016-08-30 21:25:57","2016-08-30 21:25:57"
2670,8000,1416,1416,9416,2,"2016-08-30 21:25:57","2016-08-30 21:25:57"
2671,8500,1614,1614,10114,2,"2016-08-30 21:25:57","2016-08-30 21:25:57"
2672,8000,1525,0,8000,2,"2016-08-30 21:25:57","2016-08-30 21:25:57"
2673,8000,1502,0,8000,2,"2016-08-30 21:25:57","2016-08-30 21:25:57"
2674,8500,1511,1511,10011,1,"2016-08-30 21:25:57","2016-08-30 21:25:57"
2675,9000,1535,1535,10535,1,"2016-08-30 21:25:57","2016-08-30 21:25:57"
2676,8000,1439,1439,9439,1,"2016-08-30 21:25:57","2016-08-30 21:25:57"
2677,8900,1631,0,8900,2,"2016-08-30 21:25:57","2016-08-30 21:25:57"
2678,8500,1569,1569,10069,2,"2016-08-30 21:25:57","2016-08-30 21:25:57"
2679,9500,1577,1577,11077,1,"2016-08-30 21:25:57","2016-08-30 21:25:57"
2680,8000,1555,0,8000,2,"2016-08-30 21:25:57","2016-08-30 21:25:57"
2681,8500,1436,0,8500,2,"2016-08-30 21:25:57","2016-08-30 21:25:57"
2682,7000,1417,1417,8417,1,"2016-08-30 21:25:57","2016-08-30 21:25:57"
2683,5000,1374,1374,6374,1,"2016-08-30 21:25:57","2016-08-30 21:25:57"
2684,8900,1491,0,8900,2,"2016-08-30 21:25:57","2016-08-30 21:25:57"
2685,4000,1367,1367,5367,2,"2016-08-30 21:25:57","2016-08-30 21:25:57"
2686,8900,1551,1551,10451,2,"2016-08-30 21:25:57","2016-08-30 21:25:57"
2687,8000,1524,1524,9524,2,"2016-08-30 21:25:57","2016-08-30 21:25:57"
2688,9000,1622,0,9000,2,"2016-08-30 21:25:57","2016-08-30 21:25:57"
2689,9000,1455,1455,10455,1,"2016-08-30 21:25:57","2016-08-30 21:25:57"
2690,4000,1291,1291,5291,1,"2016-08-30 21:25:57","2016-08-30 21:25:57"
2691,9500,1597,1597,11097,1,"2016-08-30 21:25:57","2016-08-30 21:25:57"
2692,9500,1674,1674,11174,1,"2016-08-30 21:25:57","2016-08-30 21:25:57"
2693,7000,1533,1533,8533,2,"2016-08-30 21:25:57","2016-08-30 21:25:57"
2694,9900,1609,0,9900,2,"2016-08-30 21:25:57","2016-08-30 21:25:57"
2695,4000,1235,1235,5235,1,"2016-08-30 21:25:57","2016-08-30 21:25:57"
2696,9900,1515,0,9900,2,"2016-08-30 21:25:57","2016-08-30 21:25:57"
2697,9900,1656,0,9900,2,"2016-08-30 21:25:57","2016-08-30 21:25:57"
2698,8000,1456,1456,9456,1,"2016-08-30 21:25:57","2016-08-30 21:25:57"
2699,8000,1562,0,8000,2,"2016-08-30 21:25:57","2016-08-30 21:25:57"
2700,8500,1433,1433,9933,1,"2016-08-30 21:25:57","2016-08-30 21:25:57"
2701,8000,1584,1584,9584,2,"2016-08-30 21:25:57","2016-08-30 21:25:57"
2702,8000,1478,0,8000,2,"2016-08-30 21:25:57","2016-08-30 21:25:57"
2703,4000,1346,1346,5346,1,"2016-08-30 21:25:57","2016-08-30 21:25:57"
2704,9500,1530,1530,11030,1,"2016-08-30 21:25:57","2016-08-30 21:25:57"
2705,9900,1505,1505,11405,1,"2016-08-30 21:25:57","2016-08-30 21:25:57"
2706,8000,1570,1570,9570,1,"2016-08-30 21:25:57","2016-08-30 21:25:57"
2707,5000,1327,1327,6327,1,"2016-08-30 21:25:57","2016-08-30 21:25:57"
2708,9500,1531,1531,11031,1,"2016-08-30 21:25:57","2016-08-30 21:25:57"
2709,8000,1409,0,8000,2,"2016-08-30 21:25:57","2016-08-30 21:25:57"
2710,8000,1427,1427,9427,1,"2016-08-30 21:25:57","2016-08-30 21:25:57"
2711,8000,1528,0,8000,2,"2016-08-30 21:25:57","2016-08-30 21:25:57"
2712,9900,1641,1641,11541,1,"2016-08-30 21:25:57","2016-08-30 21:25:57"
2713,9500,1511,0,9500,2,"2016-08-30 21:25:57","2016-08-30 21:25:57"
2714,5000,1404,1404,6404,1,"2016-08-30 21:25:57","2016-08-30 21:25:57"
2715,8900,1629,1629,10529,1,"2016-08-30 21:25:57","2016-08-30 21:25:57"
2716,8900,1601,0,8900,2,"2016-08-30 21:25:57","2016-08-30 21:25:57"
2717,4000,1272,1272,5272,1,"2016-08-30 21:25:57","2016-08-30 21:25:57"
2718,9900,1679,1679,11579,1,"2016-08-30 21:25:57","2016-08-30 21:25:57"
2719,5000,1257,1257,6257,2,"2016-08-30 21:25:57","2016-08-30 21:25:57"
2720,5000,1315,1315,6315,1,"2016-08-30 21:25:57","2016-08-30 21:25:57"
2721,4000,1377,1377,5377,2,"2016-08-30 21:25:57","2016-08-30 21:25:57"
2722,8900,1553,1553,10453,1,"2016-08-30 21:25:57","2016-08-30 21:25:57"
2723,4000,1240,1240,5240,2,"2016-08-30 21:25:57","2016-08-30 21:25:57"
2724,9900,1643,1643,11543,1,"2016-08-30 21:25:57","2016-08-30 21:25:57"
2725,8000,1456,0,8000,2,"2016-08-30 21:25:57","2016-08-30 21:25:57"
2726,4000,1369,1369,5369,1,"2016-08-30 21:25:57","2016-08-30 21:25:57"
2727,8000,1413,1413,9413,1,"2016-08-30 21:25:57","2016-08-30 21:25:57"
2728,6000,1455,1455,7455,1,"2016-08-30 21:25:57","2016-08-30 21:25:57"
2729,9000,1533,0,9000,2,"2016-08-30 21:25:57","2016-08-30 21:25:57"
2730,8000,1598,0,8000,2,"2016-08-30 21:25:57","2016-08-30 21:25:57"
2731,8900,1544,0,8900,2,"2016-08-30 21:25:57","2016-08-30 21:25:57"
2732,5000,1428,1428,6428,1,"2016-08-30 21:25:57","2016-08-30 21:25:57"
2733,9000,1549,1549,10549,1,"2016-08-30 21:25:57","2016-08-30 21:25:57"
2734,9000,1601,1601,10601,1,"2016-08-30 21:25:57","2016-08-30 21:25:57"
2735,8900,1504,1504,10404,1,"2016-08-30 21:25:57","2016-08-30 21:25:57"
2736,4000,1399,1399,5399,1,"2016-08-30 21:25:57","2016-08-30 21:25:57"
2737,9500,1584,1584,11084,1,"2016-08-30 21:25:57","2016-08-30 21:25:57"
2738,8000,1555,0,8000,2,"2016-08-30 21:25:57","2016-08-30 21:25:57"
2739,8900,1504,0,8900,2,"2016-08-30 21:25:57","2016-08-30 21:25:57"
2740,9900,1536,1536,11436,1,"2016-08-30 21:25:57","2016-08-30 21:25:57"
2741,9900,1541,1541,11441,1,"2016-08-30 21:25:57","2016-08-30 21:25:57"
2742,9000,1607,1607,10607,1,"2016-08-30 21:25:57","2016-08-30 21:25:57"
2743,6000,1397,1397,7397,2,"2016-08-30 21:25:57","2016-08-30 21:25:57"
2744,8000,1582,0,8000,2,"2016-08-30 21:25:57","2016-08-30 21:25:57"
2745,8500,1601,0,8500,2,"2016-08-30 21:25:57","2016-08-30 21:25:57"
2746,7000,1401,1401,8401,1,"2016-08-30 21:25:57","2016-08-30 21:25:57"
2747,9900,1498,1498,11398,1,"2016-08-30 21:25:57","2016-08-30 21:25:57"
2748,9000,1509,1509,10509,1,"2016-08-30 21:25:57","2016-08-30 21:25:57"
2749,8000,1412,1412,9412,2,"2016-08-30 21:25:57","2016-08-30 21:25:57"
2750,8000,1495,0,8000,2,"2016-08-30 21:25:57","2016-08-30 21:25:57"
2751,8000,1486,1486,9486,2,"2016-08-30 21:25:57","2016-08-30 21:25:57"
2752,5000,1314,1314,6314,1,"2016-08-30 21:25:57","2016-08-30 21:25:57"
2753,8500,1528,0,8500,2,"2016-08-30 21:25:57","2016-08-30 21:25:57"
2754,8500,1458,1458,9958,2,"2016-08-30 21:25:57","2016-08-30 21:25:57"
2755,5000,1315,1315,6315,1,"2016-08-30 21:25:57","2016-08-30 21:25:57"
2756,8000,1495,0,8000,2,"2016-08-30 21:25:57","2016-08-30 21:25:57"
2757,9000,1617,1617,10617,1,"2016-08-30 21:25:57","2016-08-30 21:25:57"
2758,8500,1525,0,8500,2,"2016-08-30 21:25:57","2016-08-30 21:25:57"
2759,8000,1500,0,8000,2,"2016-08-30 21:25:57","2016-08-30 21:25:57"
2760,8900,1532,1532,10432,1,"2016-08-30 21:25:57","2016-08-30 21:25:57"
2761,4000,1359,1359,5359,1,"2016-08-30 21:25:57","2016-08-30 21:25:57"
2762,8500,1460,1460,9960,1,"2016-08-30 21:25:57","2016-08-30 21:25:57"
2763,9900,1563,1563,11463,1,"2016-08-30 21:25:57","2016-08-30 21:25:57"
2764,8500,1478,1478,9978,1,"2016-08-30 21:25:57","2016-08-30 21:25:57"
2765,4000,1369,1369,5369,2,"2016-08-30 21:25:57","2016-08-30 21:25:57"
2766,4000,1211,1211,5211,2,"2016-08-30 21:25:57","2016-08-30 21:25:57"
2767,4000,1346,1346,5346,1,"2016-08-30 21:25:57","2016-08-30 21:25:57"
2768,8500,1509,0,8500,2,"2016-08-30 21:25:57","2016-08-30 21:25:57"
2769,4000,1249,1249,5249,1,"2016-08-30 21:25:57","2016-08-30 21:25:57"
2770,4000,1366,1366,5366,1,"2016-08-30 21:25:57","2016-08-30 21:25:57"
2771,7000,1516,1516,8516,1,"2016-08-30 21:25:57","2016-08-30 21:25:57"
2772,7000,1446,1446,8446,1,"2016-08-30 21:25:57","2016-08-30 21:25:57"
2773,8500,1513,1513,10013,1,"2016-08-30 21:25:57","2016-08-30 21:25:57"
2774,6000,1354,1354,7354,2,"2016-08-30 21:25:57","2016-08-30 21:25:57"
2775,8000,1596,1596,9596,1,"2016-08-30 21:25:57","2016-08-30 21:25:57"
2776,9900,1548,0,9900,2,"2016-08-30 21:25:57","2016-08-30 21:25:57"
2777,7000,1546,1546,8546,2,"2016-08-30 21:25:57","2016-08-30 21:25:57"
2778,8000,1409,1409,9409,1,"2016-08-30 21:25:57","2016-08-30 21:25:57"
2779,5000,1256,1256,6256,1,"2016-08-30 21:25:57","2016-08-30 21:25:57"
2780,5000,1319,1319,6319,1,"2016-08-30 21:25:57","2016-08-30 21:25:57"
2781,8900,1571,0,8900,2,"2016-08-30 21:25:57","2016-08-30 21:25:57"
2782,4000,1262,1262,5262,1,"2016-08-30 21:25:57","2016-08-30 21:25:57"
2783,8900,1611,1611,10511,1,"2016-08-30 21:25:57","2016-08-30 21:25:57"
2784,9900,1537,1537,11437,1,"2016-08-30 21:25:57","2016-08-30 21:25:57"
2785,8500,1449,0,8500,2,"2016-08-30 21:25:57","2016-08-30 21:25:57"
2786,8000,1554,1554,9554,1,"2016-08-30 21:25:57","2016-08-30 21:25:57"
2787,8900,1476,0,8900,2,"2016-08-30 21:25:57","2016-08-30 21:25:57"
2788,8000,1518,0,8000,2,"2016-08-30 21:25:57","2016-08-30 21:25:57"
2789,9000,1536,1536,10536,1,"2016-08-30 21:25:57","2016-08-30 21:25:57"
2790,6000,1484,1484,7484,1,"2016-08-30 21:25:57","2016-08-30 21:25:57"
2791,7000,1537,1537,8537,1,"2016-08-30 21:25:57","2016-08-30 21:25:57"
2792,8000,1561,1561,9561,1,"2016-08-30 21:25:57","2016-08-30 21:25:57"
2793,8000,1418,1418,9418,1,"2016-08-30 21:25:57","2016-08-30 21:25:57"
2794,8500,1496,0,8500,2,"2016-08-30 21:25:57","2016-08-30 21:25:57"
2795,9900,1572,1572,11472,1,"2016-08-30 21:25:57","2016-08-30 21:25:57"
2796,8900,1464,1464,10364,1,"2016-08-30 21:25:57","2016-08-30 21:25:57"
2797,9000,1605,1605,10605,1,"2016-08-30 21:25:57","2016-08-30 21:25:57"
2798,4000,1261,1261,5261,2,"2016-08-30 21:25:57","2016-08-30 21:25:57"
2799,8900,1479,0,8900,2,"2016-08-30 21:25:57","2016-08-30 21:25:57"
2800,4000,1255,1255,5255,1,"2016-08-30 21:25:57","2016-08-30 21:25:57"
2801,7000,1491,1491,8491,1,"2016-08-30 21:25:57","2016-08-30 21:25:57"
2802,8900,1605,1605,10505,2,"2016-08-30 21:25:57","2016-08-30 21:25:57"
2803,8000,1433,1433,9433,1,"2016-08-30 21:25:57","2016-08-30 21:25:57"
2804,9000,1601,1601,10601,1,"2016-08-30 21:25:57","2016-08-30 21:25:57"
2805,8500,1479,0,8500,2,"2016-08-30 21:25:57","2016-08-30 21:25:57"
2806,8000,1473,1473,9473,1,"2016-08-30 21:25:57","2016-08-30 21:25:57"
2807,8000,1572,0,8000,2,"2016-08-30 21:25:57","2016-08-30 21:25:57"
2808,8000,1457,0,8000,2,"2016-08-30 21:25:57","2016-08-30 21:25:57"
2809,8500,1520,0,8500,2,"2016-08-30 21:25:57","2016-08-30 21:25:57"
2810,8000,1580,0,8000,2,"2016-08-30 21:25:57","2016-08-30 21:25:57"
2811,8900,1590,0,8900,2,"2016-08-30 21:25:57","2016-08-30 21:25:57"
2812,8000,1590,0,8000,2,"2016-08-30 21:25:57","2016-08-30 21:25:57"
2813,8000,1566,1566,9566,2,"2016-08-30 21:25:57","2016-08-30 21:25:57"
2814,4000,1233,1233,5233,2,"2016-08-30 21:25:57","2016-08-30 21:25:57"
2815,4000,1383,1383,5383,1,"2016-08-30 21:25:57","2016-08-30 21:25:57"
2816,4000,1395,1395,5395,1,"2016-08-30 21:25:57","2016-08-30 21:25:57"
2817,5000,1259,1259,6259,1,"2016-08-30 21:25:57","2016-08-30 21:25:57"
2818,8000,1539,0,8000,2,"2016-08-30 21:25:57","2016-08-30 21:25:57"
2819,9000,1582,1582,10582,1,"2016-08-30 21:25:57","2016-08-30 21:25:57"
2820,8500,1621,0,8500,2,"2016-08-30 21:25:57","2016-08-30 21:25:57"
2821,9500,1491,1491,10991,1,"2016-08-30 21:25:57","2016-08-30 21:25:57"
2822,8900,1516,1516,10416,1,"2016-08-30 21:25:57","2016-08-30 21:25:57"
2823,8000,1570,0,8000,2,"2016-08-30 21:25:57","2016-08-30 21:25:57"
2824,8900,1595,1595,10495,2,"2016-08-30 21:25:57","2016-08-30 21:25:57"
2825,5000,1423,1423,6423,2,"2016-08-30 21:25:57","2016-08-30 21:25:57"
2826,4000,1364,1364,5364,1,"2016-08-30 21:25:57","2016-08-30 21:25:57"
2827,4000,1350,1350,5350,2,"2016-08-30 21:25:57","2016-08-30 21:25:57"
2828,8500,1530,0,8500,2,"2016-08-30 21:25:57","2016-08-30 21:25:57"
2829,8000,1542,0,8000,2,"2016-08-30 21:25:57","2016-08-30 21:25:57"
2830,8000,1511,0,8000,2,"2016-08-30 21:25:57","2016-08-30 21:25:57"
2831,7000,1371,1371,8371,1,"2016-08-30 21:25:57","2016-08-30 21:25:57"
2832,8000,1483,0,8000,2,"2016-08-30 21:25:57","2016-08-30 21:25:57"
2833,6000,1497,1497,7497,2,"2016-08-30 21:25:57","2016-08-30 21:25:57"
2834,7000,1515,1515,8515,1,"2016-08-30 21:25:57","2016-08-30 21:25:57"
2835,8000,1439,0,8000,2,"2016-08-30 21:25:57","2016-08-30 21:25:57"
2836,8000,1507,1507,9507,1,"2016-08-30 21:25:57","2016-08-30 21:25:57"
2837,8500,1472,0,8500,2,"2016-08-30 21:25:57","2016-08-30 21:25:57"
2838,9500,1531,1531,11031,1,"2016-08-30 21:25:57","2016-08-30 21:25:57"
2839,8000,1556,1556,9556,1,"2016-08-30 21:25:57","2016-08-30 21:25:57"
2840,9900,1691,1691,11591,2,"2016-08-30 21:25:57","2016-08-30 21:25:57"
2841,8500,1505,1505,10005,2,"2016-08-30 21:25:57","2016-08-30 21:25:57"
2842,5000,1386,1386,6386,2,"2016-08-30 21:25:57","2016-08-30 21:25:57"
2843,8000,1519,0,8000,2,"2016-08-30 21:25:57","2016-08-30 21:25:57"
2844,8500,1546,0,8500,2,"2016-08-30 21:25:57","2016-08-30 21:25:57"
2845,8900,1504,0,8900,2,"2016-08-30 21:25:57","2016-08-30 21:25:57"
2846,7000,1370,1370,8370,1,"2016-08-30 21:25:57","2016-08-30 21:25:57"
2847,8000,1454,1454,9454,1,"2016-08-30 21:25:57","2016-08-30 21:25:57"
2848,9000,1630,1630,10630,1,"2016-08-30 21:25:57","2016-08-30 21:25:57"
2849,8500,1596,1596,10096,2,"2016-08-30 21:25:57","2016-08-30 21:25:57"
2850,9500,1620,1620,11120,1,"2016-08-30 21:25:57","2016-08-30 21:25:57"
2851,9500,1654,1654,11154,1,"2016-08-30 21:25:57","2016-08-30 21:25:57"
2852,8500,1557,1557,10057,2,"2016-08-30 21:25:57","2016-08-30 21:25:57"
2853,4000,1203,1203,5203,2,"2016-08-30 21:25:57","2016-08-30 21:25:57"
2854,8000,1534,1534,9534,2,"2016-08-30 21:25:57","2016-08-30 21:25:57"
2855,8000,1405,1405,9405,2,"2016-08-30 21:25:57","2016-08-30 21:25:57"
2856,8000,1410,1410,9410,1,"2016-08-30 21:25:57","2016-08-30 21:25:57"
2857,8000,1502,1502,9502,1,"2016-08-30 21:25:57","2016-08-30 21:25:57"
2858,8500,1525,1525,10025,2,"2016-08-30 21:25:57","2016-08-30 21:25:57"
2859,8000,1509,1509,9509,1,"2016-08-30 21:25:57","2016-08-30 21:25:57"
2860,8500,1439,1439,9939,1,"2016-08-30 21:25:57","2016-08-30 21:25:57"
2861,9000,1612,1612,10612,1,"2016-08-30 21:25:57","2016-08-30 21:25:57"
2862,5000,1322,1322,6322,2,"2016-08-30 21:25:57","2016-08-30 21:25:57"
2863,9900,1593,1593,11493,1,"2016-08-30 21:25:57","2016-08-30 21:25:57"
2864,5000,1305,1305,6305,2,"2016-08-30 21:25:57","2016-08-30 21:25:57"
2865,4000,1227,1227,5227,2,"2016-08-30 21:25:57","2016-08-30 21:25:57"
2866,8000,1407,1407,9407,1,"2016-08-30 21:25:57","2016-08-30 21:25:57"
2867,9000,1512,0,9000,2,"2016-08-30 21:25:57","2016-08-30 21:25:57"
2868,8000,1444,0,8000,2,"2016-08-30 21:25:57","2016-08-30 21:25:57"
2869,5000,1383,1383,6383,1,"2016-08-30 21:25:57","2016-08-30 21:25:57"
2870,4000,1365,1365,5365,1,"2016-08-30 21:25:57","2016-08-30 21:25:57"
2871,9500,1531,1531,11031,1,"2016-08-30 21:25:57","2016-08-30 21:25:57"
2872,5000,1333,1333,6333,1,"2016-08-30 21:25:57","2016-08-30 21:25:57"
2873,5000,1275,1275,6275,1,"2016-08-30 21:25:57","2016-08-30 21:25:57"
2874,8900,1509,0,8900,2,"2016-08-30 21:25:57","2016-08-30 21:25:57"
2875,7000,1524,1524,8524,1,"2016-08-30 21:25:57","2016-08-30 21:25:57"
2876,8900,1492,1492,10392,1,"2016-08-30 21:25:57","2016-08-30 21:25:57"
2877,7000,1458,1458,8458,1,"2016-08-30 21:25:57","2016-08-30 21:25:57"
2878,8000,1497,1497,9497,2,"2016-08-30 21:25:57","2016-08-30 21:25:57"
2879,8500,1489,0,8500,2,"2016-08-30 21:25:57","2016-08-30 21:25:57"
2880,9900,1635,1635,11535,1,"2016-08-30 21:25:57","2016-08-30 21:25:57"
2881,6000,1445,1445,7445,1,"2016-08-30 21:25:57","2016-08-30 21:25:57"
2882,9000,1501,1501,10501,2,"2016-08-30 21:25:57","2016-08-30 21:25:57"
2883,5000,1331,1331,6331,1,"2016-08-30 21:25:57","2016-08-30 21:25:57"
2884,8000,1417,0,8000,2,"2016-08-30 21:25:57","2016-08-30 21:25:57"
2885,8000,1530,0,8000,2,"2016-08-30 21:25:57","2016-08-30 21:25:57"
2886,8500,1583,0,8500,2,"2016-08-30 21:25:57","2016-08-30 21:25:57"
2887,8500,1499,1499,9999,1,"2016-08-30 21:25:57","2016-08-30 21:25:57"
2888,9900,1549,1549,11449,2,"2016-08-30 21:25:57","2016-08-30 21:25:57"
2889,8500,1562,1562,10062,2,"2016-08-30 21:25:57","2016-08-30 21:25:57"
2890,9500,1590,1590,11090,1,"2016-08-30 21:25:57","2016-08-30 21:25:57"
2891,8500,1467,0,8500,2,"2016-08-30 21:25:57","2016-08-30 21:25:57"
2892,8000,1536,1536,9536,1,"2016-08-30 21:25:57","2016-08-30 21:25:57"
2893,8500,1477,0,8500,2,"2016-08-30 21:25:57","2016-08-30 21:25:57"
2894,8900,1465,0,8900,2,"2016-08-30 21:25:57","2016-08-30 21:25:57"
2895,7000,1447,1447,8447,2,"2016-08-30 21:25:57","2016-08-30 21:25:57"
2896,8000,1457,0,8000,2,"2016-08-30 21:25:57","2016-08-30 21:25:57"
2897,8900,1603,0,8900,2,"2016-08-30 21:25:57","2016-08-30 21:25:57"
2898,8000,1538,0,8000,2,"2016-08-30 21:25:57","2016-08-30 21:25:57"
2899,4000,1322,1322,5322,1,"2016-08-30 21:25:57","2016-08-30 21:25:57"
2900,9900,1527,1527,11427,1,"2016-08-30 21:25:57","2016-08-30 21:25:57"
2901,8500,1545,1545,10045,1,"2016-08-30 21:25:57","2016-08-30 21:25:57"
2902,8500,1504,0,8500,2,"2016-08-30 21:25:57","2016-08-30 21:25:57"
2903,8900,1527,1527,10427,2,"2016-08-30 21:25:57","2016-08-30 21:25:57"
2904,9900,1629,1629,11529,2,"2016-08-30 21:25:57","2016-08-30 21:25:57"
2905,8000,1563,0,8000,2,"2016-08-30 21:25:57","2016-08-30 21:25:57"
2906,9900,1687,1687,11587,1,"2016-08-30 21:25:57","2016-08-30 21:25:57"
2907,8000,1419,0,8000,2,"2016-08-30 21:25:57","2016-08-30 21:25:57"
2908,8500,1459,0,8500,2,"2016-08-30 21:25:57","2016-08-30 21:25:57"
2909,9500,1564,0,9500,2,"2016-08-30 21:25:57","2016-08-30 21:25:57"
2910,9900,1638,1638,11538,1,"2016-08-30 21:25:57","2016-08-30 21:25:57"
2911,8000,1443,1443,9443,1,"2016-08-30 21:25:57","2016-08-30 21:25:57"
2912,5000,1260,1260,6260,1,"2016-08-30 21:25:57","2016-08-30 21:25:57"
2913,9900,1501,1501,11401,1,"2016-08-30 21:25:57","2016-08-30 21:25:57"
2914,5000,1321,1321,6321,2,"2016-08-30 21:25:57","2016-08-30 21:25:57"
2915,9900,1687,0,9900,2,"2016-08-30 21:25:57","2016-08-30 21:25:57"
2916,9000,1481,1481,10481,1,"2016-08-30 21:25:57","2016-08-30 21:25:57"
2917,8500,1550,1550,10050,2,"2016-08-30 21:25:57","2016-08-30 21:25:57"
2918,4000,1220,1220,5220,1,"2016-08-30 21:25:57","2016-08-30 21:25:57"
2919,6000,1403,1403,7403,1,"2016-08-30 21:25:57","2016-08-30 21:25:57"
2920,8900,1531,1531,10431,1,"2016-08-30 21:25:57","2016-08-30 21:25:57"
2921,8000,1551,0,8000,2,"2016-08-30 21:25:57","2016-08-30 21:25:57"
2922,5000,1406,1406,6406,1,"2016-08-30 21:25:57","2016-08-30 21:25:57"
2923,8000,1422,0,8000,2,"2016-08-30 21:25:57","2016-08-30 21:25:57"
2924,9900,1507,1507,11407,1,"2016-08-30 21:25:57","2016-08-30 21:25:57"
2925,9900,1666,1666,11566,1,"2016-08-30 21:25:57","2016-08-30 21:25:57"
2926,8000,1535,1535,9535,2,"2016-08-30 21:25:57","2016-08-30 21:25:57"
2927,5000,1356,1356,6356,1,"2016-08-30 21:25:57","2016-08-30 21:25:57"
2928,8500,1455,1455,9955,2,"2016-08-30 21:25:57","2016-08-30 21:25:57"
2929,8500,1468,1468,9968,1,"2016-08-30 21:25:57","2016-08-30 21:25:57"
2930,8900,1479,1479,10379,1,"2016-08-30 21:25:57","2016-08-30 21:25:57"
2931,8500,1571,0,8500,2,"2016-08-30 21:25:57","2016-08-30 21:25:57"
2932,8500,1497,0,8500,2,"2016-08-30 21:25:57","2016-08-30 21:25:57"
2933,7000,1504,1504,8504,1,"2016-08-30 21:25:57","2016-08-30 21:25:57"
2934,9500,1661,0,9500,2,"2016-08-30 21:25:57","2016-08-30 21:25:57"
2935,5000,1282,1282,6282,2,"2016-08-30 21:25:57","2016-08-30 21:25:57"
2936,8000,1418,1418,9418,1,"2016-08-30 21:25:57","2016-08-30 21:25:57"
2937,4000,1202,1202,5202,1,"2016-08-30 21:25:57","2016-08-30 21:25:57"
2938,8500,1563,1563,10063,2,"2016-08-30 21:25:57","2016-08-30 21:25:57"
2939,4000,1302,1302,5302,2,"2016-08-30 21:25:57","2016-08-30 21:25:57"
2940,8500,1518,0,8500,2,"2016-08-30 21:25:57","2016-08-30 21:25:57"
2941,7000,1429,1429,8429,1,"2016-08-30 21:25:57","2016-08-30 21:25:57"
2942,8500,1516,1516,10016,1,"2016-08-30 21:25:57","2016-08-30 21:25:57"
2943,5000,1256,1256,6256,1,"2016-08-30 21:25:57","2016-08-30 21:25:57"
2944,8000,1475,0,8000,2,"2016-08-30 21:25:57","2016-08-30 21:25:57"
2945,8900,1514,0,8900,2,"2016-08-30 21:25:57","2016-08-30 21:25:57"
2946,9900,1664,1664,11564,1,"2016-08-30 21:25:57","2016-08-30 21:25:57"
2947,9500,1650,1650,11150,1,"2016-08-30 21:25:57","2016-08-30 21:25:57"
2948,5000,1301,1301,6301,2,"2016-08-30 21:25:57","2016-08-30 21:25:57"
2949,9000,1613,1613,10613,1,"2016-08-30 21:25:57","2016-08-30 21:25:57"
2950,8000,1438,0,8000,2,"2016-08-30 21:25:57","2016-08-30 21:25:57"
2951,8900,1638,0,8900,2,"2016-08-30 21:25:57","2016-08-30 21:25:57"
2952,8000,1594,0,8000,2,"2016-08-30 21:25:58","2016-08-30 21:25:58"
2953,8000,1416,1416,9416,2,"2016-08-30 21:25:58","2016-08-30 21:25:58"
2954,8000,1482,0,8000,2,"2016-08-30 21:25:58","2016-08-30 21:25:58"
2955,5000,1268,1268,6268,1,"2016-08-30 21:25:58","2016-08-30 21:25:58"
2956,8000,1455,0,8000,2,"2016-08-30 21:25:58","2016-08-30 21:25:58"
2957,9500,1589,1589,11089,1,"2016-08-30 21:25:58","2016-08-30 21:25:58"
2958,8500,1555,1555,10055,1,"2016-08-30 21:25:58","2016-08-30 21:25:58"
2959,4000,1255,1255,5255,1,"2016-08-30 21:25:58","2016-08-30 21:25:58"
2960,6000,1373,1373,7373,1,"2016-08-30 21:25:58","2016-08-30 21:25:58"
2961,5000,1351,1351,6351,1,"2016-08-30 21:25:58","2016-08-30 21:25:58"
2962,4000,1288,1288,5288,1,"2016-08-30 21:25:58","2016-08-30 21:25:58"
2963,4000,1306,1306,5306,2,"2016-08-30 21:25:58","2016-08-30 21:25:58"
2964,8000,1438,1438,9438,2,"2016-08-30 21:25:58","2016-08-30 21:25:58"
2965,6000,1410,1410,7410,1,"2016-08-30 21:25:58","2016-08-30 21:25:58"
2966,7000,1544,1544,8544,1,"2016-08-30 21:25:58","2016-08-30 21:25:58"
2967,8000,1425,1425,9425,2,"2016-08-30 21:25:58","2016-08-30 21:25:58"
2968,8500,1570,0,8500,2,"2016-08-30 21:25:58","2016-08-30 21:25:58"
2969,9500,1580,1580,11080,1,"2016-08-30 21:25:58","2016-08-30 21:25:58"
2970,8000,1416,0,8000,2,"2016-08-30 21:25:58","2016-08-30 21:25:58"
2971,8900,1536,0,8900,2,"2016-08-30 21:25:58","2016-08-30 21:25:58"
2972,8900,1492,0,8900,2,"2016-08-30 21:25:58","2016-08-30 21:25:58"
2973,8500,1573,1573,10073,1,"2016-08-30 21:25:58","2016-08-30 21:25:58"
2974,8000,1519,0,8000,2,"2016-08-30 21:25:58","2016-08-30 21:25:58"
2975,7000,1402,1402,8402,1,"2016-08-30 21:25:58","2016-08-30 21:25:58"
2976,8000,1434,0,8000,2,"2016-08-30 21:25:58","2016-08-30 21:25:58"
2977,9500,1488,1488,10988,1,"2016-08-30 21:25:58","2016-08-30 21:25:58"
2978,9000,1515,1515,10515,1,"2016-08-30 21:25:58","2016-08-30 21:25:58"
2979,8500,1615,1615,10115,2,"2016-08-30 21:25:58","2016-08-30 21:25:58"
2980,8900,1552,0,8900,2,"2016-08-30 21:25:58","2016-08-30 21:25:58"
2981,7000,1467,1467,8467,1,"2016-08-30 21:25:58","2016-08-30 21:25:58"
2982,8500,1493,0,8500,2,"2016-08-30 21:25:58","2016-08-30 21:25:58"
2983,8000,1416,0,8000,2,"2016-08-30 21:25:58","2016-08-30 21:25:58"
2984,8000,1582,1582,9582,1,"2016-08-30 21:25:58","2016-08-30 21:25:58"
2985,8900,1507,1507,10407,2,"2016-08-30 21:25:58","2016-08-30 21:25:58"
2986,9900,1658,1658,11558,1,"2016-08-30 21:25:58","2016-08-30 21:25:58"
2987,8000,1544,1544,9544,1,"2016-08-30 21:25:58","2016-08-30 21:25:58"
2988,4000,1366,1366,5366,1,"2016-08-30 21:25:58","2016-08-30 21:25:58"
2989,9500,1477,1477,10977,1,"2016-08-30 21:25:58","2016-08-30 21:25:58"
2990,8000,1462,1462,9462,1,"2016-08-30 21:25:58","2016-08-30 21:25:58"
2991,8900,1539,0,8900,2,"2016-08-30 21:25:58","2016-08-30 21:25:58"
2992,4000,1372,1372,5372,1,"2016-08-30 21:25:58","2016-08-30 21:25:58"
2993,8000,1450,1450,9450,2,"2016-08-30 21:25:58","2016-08-30 21:25:58"
2994,8000,1431,1431,9431,1,"2016-08-30 21:25:58","2016-08-30 21:25:58"
2995,9500,1500,0,9500,2,"2016-08-30 21:25:58","2016-08-30 21:25:58"
2996,8900,1489,0,8900,2,"2016-08-30 21:25:58","2016-08-30 21:25:58"
2997,7000,1395,1395,8395,1,"2016-08-30 21:25:58","2016-08-30 21:25:58"
2998,9000,1484,1484,10484,1,"2016-08-30 21:25:58","2016-08-30 21:25:58"
2999,8000,1557,1557,9557,2,"2016-08-30 21:25:58","2016-08-30 21:25:58"
3000,9000,1451,1451,10451,1,"2016-08-30 21:25:58","2016-08-30 21:25:58"
3001,8900,1450,1450,10350,1,"2016-08-30 21:25:58","2016-08-30 21:25:58"
3002,7000,1522,1522,8522,1,"2016-08-30 21:25:58","2016-08-30 21:25:58"
3003,8000,1450,0,8000,2,"2016-08-30 21:25:58","2016-08-30 21:25:58"
3004,9000,1478,1478,10478,1,"2016-08-30 21:25:58","2016-08-30 21:25:58"
3005,8900,1461,0,8900,2,"2016-08-30 21:25:58","2016-08-30 21:25:58"
3006,8500,1428,1428,9928,1,"2016-08-30 21:25:58","2016-08-30 21:25:58"
3007,8900,1468,1468,10368,2,"2016-08-30 21:25:58","2016-08-30 21:25:58"
3008,7000,1402,1402,8402,1,"2016-08-30 21:25:58","2016-08-30 21:25:58"
3009,7000,1432,1432,8432,2,"2016-08-30 21:25:58","2016-08-30 21:25:58"
3010,8000,1588,1588,9588,1,"2016-08-30 21:25:58","2016-08-30 21:25:58"
3011,8500,1532,1532,10032,1,"2016-08-30 21:25:58","2016-08-30 21:25:58"
3012,6000,1413,1413,7413,1,"2016-08-30 21:25:58","2016-08-30 21:25:58"
3013,6000,1365,1365,7365,1,"2016-08-30 21:25:58","2016-08-30 21:25:58"
3014,8000,1477,0,8000,2,"2016-08-30 21:25:58","2016-08-30 21:25:58"
3015,5000,1398,1398,6398,1,"2016-08-30 21:25:58","2016-08-30 21:25:58"
3016,4000,1292,1292,5292,1,"2016-08-30 21:25:58","2016-08-30 21:25:58"
3017,9000,1575,1575,10575,1,"2016-08-30 21:25:58","2016-08-30 21:25:58"
3018,8000,1557,1557,9557,2,"2016-08-30 21:25:58","2016-08-30 21:25:58"
3019,7000,1520,1520,8520,1,"2016-08-30 21:25:58","2016-08-30 21:25:58"
3020,8000,1576,1576,9576,1,"2016-08-30 21:25:58","2016-08-30 21:25:58"
3021,9500,1500,1500,11000,1,"2016-08-30 21:25:58","2016-08-30 21:25:58"
3022,8500,1458,1458,9958,1,"2016-08-30 21:25:58","2016-08-30 21:25:58"
3023,8500,1497,0,8500,2,"2016-08-30 21:25:58","2016-08-30 21:25:58"
3024,8000,1474,1474,9474,1,"2016-08-30 21:25:58","2016-08-30 21:25:58"
3025,8000,1411,1411,9411,1,"2016-08-30 21:25:58","2016-08-30 21:25:58"
3026,9900,1610,1610,11510,1,"2016-08-30 21:25:58","2016-08-30 21:25:58"
3027,8000,1508,0,8000,2,"2016-08-30 21:25:58","2016-08-30 21:25:58"
3028,8000,1495,0,8000,2,"2016-08-30 21:25:58","2016-08-30 21:25:58"
3029,7000,1486,1486,8486,1,"2016-08-30 21:25:58","2016-08-30 21:25:58"
3030,8500,1511,1511,10011,2,"2016-08-30 21:25:58","2016-08-30 21:25:58"
3031,4000,1212,1212,5212,2,"2016-08-30 21:25:58","2016-08-30 21:25:58"
3032,8500,1568,0,8500,2,"2016-08-30 21:25:58","2016-08-30 21:25:58"
3033,8000,1407,0,8000,2,"2016-08-30 21:25:58","2016-08-30 21:25:58"
3034,6000,1370,1370,7370,2,"2016-08-30 21:25:58","2016-08-30 21:25:58"
3035,8900,1474,1474,10374,2,"2016-08-30 21:25:58","2016-08-30 21:25:58"
3036,8500,1523,1523,10023,1,"2016-08-30 21:25:58","2016-08-30 21:25:58"
3037,8000,1539,1539,9539,2,"2016-08-30 21:25:58","2016-08-30 21:25:58"
3038,4000,1320,1320,5320,2,"2016-08-30 21:25:58","2016-08-30 21:25:58"
3039,4000,1240,1240,5240,1,"2016-08-30 21:25:58","2016-08-30 21:25:58"
3040,8000,1407,1407,9407,1,"2016-08-30 21:25:58","2016-08-30 21:25:58"
3041,5000,1255,1255,6255,1,"2016-08-30 21:25:58","2016-08-30 21:25:58"
3042,8500,1451,1451,9951,1,"2016-08-30 21:25:58","2016-08-30 21:25:58"
3043,8500,1539,0,8500,2,"2016-08-30 21:25:58","2016-08-30 21:25:58"
3044,8500,1599,0,8500,2,"2016-08-30 21:25:58","2016-08-30 21:25:58"
3045,9000,1537,1537,10537,1,"2016-08-30 21:25:58","2016-08-30 21:25:58"
3046,4000,1396,1396,5396,2,"2016-08-30 21:25:58","2016-08-30 21:25:58"
3047,8500,1458,1458,9958,1,"2016-08-30 21:25:58","2016-08-30 21:25:58"
3048,8500,1593,0,8500,2,"2016-08-30 21:25:58","2016-08-30 21:25:58"
3049,8000,1446,0,8000,2,"2016-08-30 21:25:58","2016-08-30 21:25:58"
3050,7000,1527,1527,8527,1,"2016-08-30 21:25:58","2016-08-30 21:25:58"
3051,9500,1642,1642,11142,1,"2016-08-30 21:25:58","2016-08-30 21:25:58"
3052,9000,1464,1464,10464,1,"2016-08-30 21:25:58","2016-08-30 21:25:58"
3053,8000,1584,0,8000,2,"2016-08-30 21:25:58","2016-08-30 21:25:58"
3054,8000,1431,0,8000,2,"2016-08-30 21:25:58","2016-08-30 21:25:58"
3055,8000,1445,0,8000,2,"2016-08-30 21:25:58","2016-08-30 21:25:58"
3056,8000,1540,0,8000,2,"2016-08-30 21:25:58","2016-08-30 21:25:58"
3057,5000,1421,1421,6421,1,"2016-08-30 21:25:58","2016-08-30 21:25:58"
3058,6000,1341,1341,7341,1,"2016-08-30 21:25:58","2016-08-30 21:25:58"
3059,4000,1330,1330,5330,1,"2016-08-30 21:25:58","2016-08-30 21:25:58"
3060,8500,1517,1517,10017,1,"2016-08-30 21:25:58","2016-08-30 21:25:58"
3061,8900,1571,0,8900,2,"2016-08-30 21:25:58","2016-08-30 21:25:58"
3062,5000,1411,1411,6411,2,"2016-08-30 21:25:58","2016-08-30 21:25:58"
3063,8500,1473,0,8500,2,"2016-08-30 21:25:58","2016-08-30 21:25:58"
3064,7000,1502,1502,8502,2,"2016-08-30 21:25:58","2016-08-30 21:25:58"
3065,8900,1496,1496,10396,1,"2016-08-30 21:25:58","2016-08-30 21:25:58"
3066,7000,1403,1403,8403,1,"2016-08-30 21:25:58","2016-08-30 21:25:58"
3067,9900,1511,1511,11411,1,"2016-08-30 21:25:58","2016-08-30 21:25:58"
3068,8500,1460,0,8500,2,"2016-08-30 21:25:58","2016-08-30 21:25:58"
3069,8500,1621,0,8500,2,"2016-08-30 21:25:58","2016-08-30 21:25:58"
3070,8000,1488,0,8000,2,"2016-08-30 21:25:58","2016-08-30 21:25:58"
3071,8000,1576,1576,9576,1,"2016-08-30 21:25:58","2016-08-30 21:25:58"
3072,8000,1468,0,8000,2,"2016-08-30 21:25:58","2016-08-30 21:25:58"
3073,5000,1328,1328,6328,1,"2016-08-30 21:25:58","2016-08-30 21:25:58"
3074,4000,1215,1215,5215,1,"2016-08-30 21:25:58","2016-08-30 21:25:58"
3075,6000,1467,1467,7467,1,"2016-08-30 21:25:58","2016-08-30 21:25:58"
3076,4000,1222,1222,5222,1,"2016-08-30 21:25:58","2016-08-30 21:25:58"
3077,8500,1552,0,8500,2,"2016-08-30 21:25:58","2016-08-30 21:25:58"
3078,9000,1622,1622,10622,1,"2016-08-30 21:25:58","2016-08-30 21:25:58"
3079,8500,1609,1609,10109,2,"2016-08-30 21:25:58","2016-08-30 21:25:58"
3080,5000,1408,1408,6408,2,"2016-08-30 21:25:58","2016-08-30 21:25:58"
3081,9900,1521,0,9900,2,"2016-08-30 21:25:58","2016-08-30 21:25:58"
3082,8000,1518,0,8000,2,"2016-08-30 21:25:58","2016-08-30 21:25:58"
3083,4000,1303,1303,5303,1,"2016-08-30 21:25:58","2016-08-30 21:25:58"
3084,9000,1532,1532,10532,1,"2016-08-30 21:25:58","2016-08-30 21:25:58"
3085,5000,1445,1445,6445,1,"2016-08-30 21:25:58","2016-08-30 21:25:58"
3086,5000,1425,1425,6425,1,"2016-08-30 21:25:58","2016-08-30 21:25:58"
3087,9900,1590,1590,11490,1,"2016-08-30 21:25:58","2016-08-30 21:25:58"
3088,8000,1462,1462,9462,2,"2016-08-30 21:25:58","2016-08-30 21:25:58"
3089,8000,1582,1582,9582,2,"2016-08-30 21:25:58","2016-08-30 21:25:58"
3090,8000,1457,0,8000,2,"2016-08-30 21:25:58","2016-08-30 21:25:58"
3091,8000,1549,0,8000,2,"2016-08-30 21:25:58","2016-08-30 21:25:58"
3092,8000,1474,1474,9474,2,"2016-08-30 21:25:58","2016-08-30 21:25:58"
3093,8000,1471,1471,9471,2,"2016-08-30 21:25:58","2016-08-30 21:25:58"
3094,4000,1203,1203,5203,2,"2016-08-30 21:25:58","2016-08-30 21:25:58"
3095,4000,1227,1227,5227,2,"2016-08-30 21:25:58","2016-08-30 21:25:58"
3096,8000,1412,1412,9412,1,"2016-08-30 21:25:58","2016-08-30 21:25:58"
3097,4000,1390,1390,5390,1,"2016-08-30 21:25:58","2016-08-30 21:25:58"
3098,8500,1595,0,8500,2,"2016-08-30 21:25:58","2016-08-30 21:25:58"
3099,9000,1495,1495,10495,1,"2016-08-30 21:25:58","2016-08-30 21:25:58"
3100,5000,1366,1366,6366,1,"2016-08-30 21:25:58","2016-08-30 21:25:58"
3101,8000,1533,0,8000,2,"2016-08-30 21:25:58","2016-08-30 21:25:58"
3102,8000,1596,0,8000,2,"2016-08-30 21:25:58","2016-08-30 21:25:58"
3103,6000,1494,1494,7494,2,"2016-08-30 21:25:58","2016-08-30 21:25:58"
3104,8900,1637,0,8900,2,"2016-08-30 21:25:58","2016-08-30 21:25:58"
3105,8000,1536,1536,9536,1,"2016-08-30 21:25:58","2016-08-30 21:25:58"
3106,9000,1619,1619,10619,1,"2016-08-30 21:25:58","2016-08-30 21:25:58"
3107,9900,1637,1637,11537,1,"2016-08-30 21:25:58","2016-08-30 21:25:58"
3108,9500,1507,1507,11007,1,"2016-08-30 21:25:58","2016-08-30 21:25:58"
3109,8000,1547,1547,9547,1,"2016-08-30 21:25:58","2016-08-30 21:25:58"
3110,8500,1451,1451,9951,2,"2016-08-30 21:25:58","2016-08-30 21:25:58"
3111,4000,1311,1311,5311,1,"2016-08-30 21:25:58","2016-08-30 21:25:58"
3112,8500,1474,0,8500,2,"2016-08-30 21:25:58","2016-08-30 21:25:58"
3113,8500,1490,0,8500,2,"2016-08-30 21:25:58","2016-08-30 21:25:58"
3114,5000,1370,1370,6370,1,"2016-08-30 21:25:58","2016-08-30 21:25:58"
3115,8500,1526,0,8500,2,"2016-08-30 21:25:58","2016-08-30 21:25:58"
3116,9500,1476,1476,10976,1,"2016-08-30 21:25:58","2016-08-30 21:25:58"
3117,8000,1565,0,8000,2,"2016-08-30 21:25:58","2016-08-30 21:25:58"
3118,8900,1490,1490,10390,1,"2016-08-30 21:25:58","2016-08-30 21:25:58"
3119,8900,1460,0,8900,2,"2016-08-30 21:25:58","2016-08-30 21:25:58"
3120,6000,1307,1307,7307,2,"2016-08-30 21:25:58","2016-08-30 21:25:58"
3121,8000,1580,1580,9580,2,"2016-08-30 21:25:58","2016-08-30 21:25:58"
3122,8500,1456,1456,9956,1,"2016-08-30 21:25:58","2016-08-30 21:25:58"
3123,8000,1523,1523,9523,2,"2016-08-30 21:25:58","2016-08-30 21:25:58"
3124,8000,1504,1504,9504,2,"2016-08-30 21:25:58","2016-08-30 21:25:58"
3125,8000,1434,1434,9434,2,"2016-08-30 21:25:58","2016-08-30 21:25:58"
3126,8900,1616,1616,10516,1,"2016-08-30 21:25:58","2016-08-30 21:25:58"
3127,8000,1496,0,8000,2,"2016-08-30 21:25:58","2016-08-30 21:25:58"
3128,9900,1656,1656,11556,1,"2016-08-30 21:25:58","2016-08-30 21:25:58"
3129,8500,1561,0,8500,2,"2016-08-30 21:25:58","2016-08-30 21:25:58"
3130,8000,1534,0,8000,2,"2016-08-30 21:25:58","2016-08-30 21:25:58"
3131,9900,1656,1656,11556,2,"2016-08-30 21:25:58","2016-08-30 21:25:58"
3132,8500,1505,1505,10005,2,"2016-08-30 21:25:58","2016-08-30 21:25:58"
3133,7000,1443,1443,8443,1,"2016-08-30 21:25:58","2016-08-30 21:25:58"
3134,9900,1686,1686,11586,1,"2016-08-30 21:25:58","2016-08-30 21:25:58"
3135,4000,1383,1383,5383,2,"2016-08-30 21:25:58","2016-08-30 21:25:58"
3136,8900,1518,0,8900,2,"2016-08-30 21:25:58","2016-08-30 21:25:58"
3137,8000,1563,1563,9563,1,"2016-08-30 21:25:58","2016-08-30 21:25:58"
3138,5000,1262,1262,6262,1,"2016-08-30 21:25:58","2016-08-30 21:25:58"
3139,8900,1559,0,8900,2,"2016-08-30 21:25:58","2016-08-30 21:25:58"
3140,4000,1285,1285,5285,1,"2016-08-30 21:25:58","2016-08-30 21:25:58"
3141,4000,1324,1324,5324,1,"2016-08-30 21:25:58","2016-08-30 21:25:58"
3142,6000,1486,1486,7486,1,"2016-08-30 21:25:58","2016-08-30 21:25:58"
3143,4000,1392,1392,5392,1,"2016-08-30 21:25:58","2016-08-30 21:25:58"
3144,8500,1431,1431,9931,1,"2016-08-30 21:25:58","2016-08-30 21:25:58"
3145,4000,1343,1343,5343,1,"2016-08-30 21:25:58","2016-08-30 21:25:58"
3146,8900,1472,1472,10372,2,"2016-08-30 21:25:58","2016-08-30 21:25:58"
3147,7000,1484,1484,8484,1,"2016-08-30 21:25:58","2016-08-30 21:25:58"
3148,8500,1498,1498,9998,2,"2016-08-30 21:25:58","2016-08-30 21:25:58"
3149,8000,1586,0,8000,2,"2016-08-30 21:25:58","2016-08-30 21:25:58"
3150,8000,1541,1541,9541,1,"2016-08-30 21:25:58","2016-08-30 21:25:58"
3151,6000,1491,1491,7491,1,"2016-08-30 21:25:58","2016-08-30 21:25:58"
3152,5000,1316,1316,6316,1,"2016-08-30 21:25:58","2016-08-30 21:25:58"
3153,6000,1467,1467,7467,1,"2016-08-30 21:25:58","2016-08-30 21:25:58"
3154,8000,1552,1552,9552,2,"2016-08-30 21:25:58","2016-08-30 21:25:58"
3155,8900,1548,0,8900,2,"2016-08-30 21:25:58","2016-08-30 21:25:58"
3156,8500,1606,1606,10106,2,"2016-08-30 21:25:58","2016-08-30 21:25:58"
3157,8900,1529,0,8900,2,"2016-08-30 21:25:58","2016-08-30 21:25:58"
3158,9000,1590,1590,10590,1,"2016-08-30 21:25:58","2016-08-30 21:25:58"
3159,8500,1548,1548,10048,2,"2016-08-30 21:25:58","2016-08-30 21:25:58"
3160,4000,1382,1382,5382,2,"2016-08-30 21:25:58","2016-08-30 21:25:58"
3161,8000,1529,0,8000,2,"2016-08-30 21:25:58","2016-08-30 21:25:58"
3162,8000,1586,0,8000,2,"2016-08-30 21:25:58","2016-08-30 21:25:58"
3163,8500,1547,1547,10047,1,"2016-08-30 21:25:58","2016-08-30 21:25:58"
3164,8000,1413,1413,9413,1,"2016-08-30 21:25:58","2016-08-30 21:25:58"
3165,8000,1583,1583,9583,1,"2016-08-30 21:25:58","2016-08-30 21:25:58"
3166,8900,1569,0,8900,2,"2016-08-30 21:25:58","2016-08-30 21:25:58"
3167,8000,1568,0,8000,2,"2016-08-30 21:25:58","2016-08-30 21:25:58"
3168,8500,1561,1561,10061,2,"2016-08-30 21:25:58","2016-08-30 21:25:58"
3169,8000,1407,0,8000,2,"2016-08-30 21:25:58","2016-08-30 21:25:58"
3170,8900,1511,0,8900,2,"2016-08-30 21:25:58","2016-08-30 21:25:58"
3171,4000,1394,1394,5394,1,"2016-08-30 21:25:58","2016-08-30 21:25:58"
3172,8000,1449,1449,9449,1,"2016-08-30 21:25:58","2016-08-30 21:25:58"
3173,7000,1479,1479,8479,1,"2016-08-30 21:25:58","2016-08-30 21:25:58"
3174,5000,1369,1369,6369,1,"2016-08-30 21:25:58","2016-08-30 21:25:58"
3175,8500,1477,0,8500,2,"2016-08-30 21:25:58","2016-08-30 21:25:58"
3176,4000,1381,1381,5381,1,"2016-08-30 21:25:58","2016-08-30 21:25:58"
3177,8000,1429,0,8000,2,"2016-08-30 21:25:58","2016-08-30 21:25:58"
3178,5000,1379,1379,6379,2,"2016-08-30 21:25:58","2016-08-30 21:25:58"
3179,8000,1522,0,8000,2,"2016-08-30 21:25:58","2016-08-30 21:25:58"
3180,8000,1496,1496,9496,2,"2016-08-30 21:25:58","2016-08-30 21:25:58"
3181,4000,1272,1272,5272,2,"2016-08-30 21:25:58","2016-08-30 21:25:58"
3182,4000,1202,1202,5202,1,"2016-08-30 21:25:58","2016-08-30 21:25:58"
3183,8000,1458,0,8000,2,"2016-08-30 21:25:58","2016-08-30 21:25:58"
3184,5000,1266,1266,6266,1,"2016-08-30 21:25:58","2016-08-30 21:25:58"
3185,9000,1643,1643,10643,1,"2016-08-30 21:25:58","2016-08-30 21:25:58"
3186,8900,1574,1574,10474,1,"2016-08-30 21:25:58","2016-08-30 21:25:58"
3187,8500,1449,0,8500,2,"2016-08-30 21:25:58","2016-08-30 21:25:58"
3188,8900,1629,0,8900,2,"2016-08-30 21:25:58","2016-08-30 21:25:58"
3189,8000,1511,0,8000,2,"2016-08-30 21:25:58","2016-08-30 21:25:58"
3190,8000,1426,1426,9426,1,"2016-08-30 21:25:58","2016-08-30 21:25:58"
3191,4000,1265,1265,5265,1,"2016-08-30 21:25:58","2016-08-30 21:25:58"
3192,8500,1525,0,8500,2,"2016-08-30 21:25:58","2016-08-30 21:25:58"
3193,8000,1433,1433,9433,1,"2016-08-30 21:25:58","2016-08-30 21:25:58"
3194,8900,1470,0,8900,2,"2016-08-30 21:25:58","2016-08-30 21:25:58"
3195,8000,1599,0,8000,2,"2016-08-30 21:25:58","2016-08-30 21:25:58"
3196,8500,1535,0,8500,2,"2016-08-30 21:25:58","2016-08-30 21:25:58"
3197,5000,1324,1324,6324,2,"2016-08-30 21:25:58","2016-08-30 21:25:58"
3198,5000,1255,1255,6255,1,"2016-08-30 21:25:58","2016-08-30 21:25:58"
3199,8500,1464,1464,9964,1,"2016-08-30 21:25:58","2016-08-30 21:25:58"
3200,8000,1539,0,8000,2,"2016-08-30 21:25:58","2016-08-30 21:25:58"
3201,8500,1455,0,8500,2,"2016-08-30 21:25:58","2016-08-30 21:25:58"
3202,8900,1587,1587,10487,1,"2016-08-30 21:25:58","2016-08-30 21:25:58"
3203,8000,1401,0,8000,2,"2016-08-30 21:25:58","2016-08-30 21:25:58"
3204,8500,1608,0,8500,2,"2016-08-30 21:25:58","2016-08-30 21:25:58"
3205,9500,1629,0,9500,2,"2016-08-30 21:25:58","2016-08-30 21:25:58"
3206,8000,1583,1583,9583,1,"2016-08-30 21:25:58","2016-08-30 21:25:58"
3207,4000,1329,1329,5329,1,"2016-08-30 21:25:58","2016-08-30 21:25:58"
3208,8000,1441,1441,9441,2,"2016-08-30 21:25:58","2016-08-30 21:25:58"
3209,9900,1582,1582,11482,1,"2016-08-30 21:25:58","2016-08-30 21:25:58"
3210,8500,1603,0,8500,2,"2016-08-30 21:25:58","2016-08-30 21:25:58"
3211,8900,1559,1559,10459,1,"2016-08-30 21:25:58","2016-08-30 21:25:58"
3212,8500,1467,0,8500,2,"2016-08-30 21:25:58","2016-08-30 21:25:58"
3213,7000,1439,1439,8439,1,"2016-08-30 21:25:58","2016-08-30 21:25:58"
3214,8500,1425,1425,9925,1,"2016-08-30 21:25:58","2016-08-30 21:25:58"
3215,4000,1300,1300,5300,1,"2016-08-30 21:25:58","2016-08-30 21:25:58"
3216,9900,1539,1539,11439,1,"2016-08-30 21:25:58","2016-08-30 21:25:58"
3217,9500,1637,1637,11137,1,"2016-08-30 21:25:58","2016-08-30 21:25:58"
3218,7000,1369,1369,8369,1,"2016-08-30 21:25:58","2016-08-30 21:25:58"
3219,5000,1340,1340,6340,1,"2016-08-30 21:25:58","2016-08-30 21:25:58"
3220,6000,1416,1416,7416,1,"2016-08-30 21:25:58","2016-08-30 21:25:58"
3221,5000,1264,1264,6264,1,"2016-08-30 21:25:58","2016-08-30 21:25:58"
3222,8000,1521,1521,9521,1,"2016-08-30 21:25:58","2016-08-30 21:25:58"
3223,4000,1217,1217,5217,1,"2016-08-30 21:25:58","2016-08-30 21:25:58"
3224,8500,1518,0,8500,2,"2016-08-30 21:25:58","2016-08-30 21:25:58"
3225,9900,1600,1600,11500,1,"2016-08-30 21:25:58","2016-08-30 21:25:58"
3226,4000,1241,1241,5241,2,"2016-08-30 21:25:58","2016-08-30 21:25:58"
3227,6000,1455,1455,7455,1,"2016-08-30 21:25:58","2016-08-30 21:25:58"
3228,8500,1461,0,8500,2,"2016-08-30 21:25:58","2016-08-30 21:25:58"
3229,7000,1365,1365,8365,2,"2016-08-30 21:25:58","2016-08-30 21:25:58"
3230,7000,1485,1485,8485,1,"2016-08-30 21:25:58","2016-08-30 21:25:58"
3231,5000,1302,1302,6302,1,"2016-08-30 21:25:58","2016-08-30 21:25:58"
3232,4000,1374,1374,5374,1,"2016-08-30 21:25:58","2016-08-30 21:25:58"
3233,4000,1322,1322,5322,1,"2016-08-30 21:25:58","2016-08-30 21:25:58"
3234,5000,1299,1299,6299,1,"2016-08-30 21:25:58","2016-08-30 21:25:58"
3235,4000,1233,1233,5233,1,"2016-08-30 21:25:58","2016-08-30 21:25:58"
3236,5000,1277,1277,6277,2,"2016-08-30 21:25:58","2016-08-30 21:25:58"
3237,8000,1430,0,8000,2,"2016-08-30 21:25:58","2016-08-30 21:25:58"
3238,8900,1574,1574,10474,1,"2016-08-30 21:25:58","2016-08-30 21:25:58"
3239,7000,1540,1540,8540,1,"2016-08-30 21:25:58","2016-08-30 21:25:58"
3240,8000,1523,0,8000,2,"2016-08-30 21:25:58","2016-08-30 21:25:58"
3241,5000,1399,1399,6399,1,"2016-08-30 21:25:58","2016-08-30 21:25:58"
3242,4000,1327,1327,5327,1,"2016-08-30 21:25:58","2016-08-30 21:25:58"
3243,8000,1478,1478,9478,2,"2016-08-30 21:25:58","2016-08-30 21:25:58"
3244,9900,1514,1514,11414,1,"2016-08-30 21:25:58","2016-08-30 21:25:58"
3245,8000,1488,0,8000,2,"2016-08-30 21:25:58","2016-08-30 21:25:58"
3246,8000,1571,0,8000,2,"2016-08-30 21:25:58","2016-08-30 21:25:58"
3247,8000,1512,1512,9512,2,"2016-08-30 21:25:58","2016-08-30 21:25:58"
3248,8500,1526,0,8500,2,"2016-08-30 21:25:58","2016-08-30 21:25:58"
3249,9900,1666,1666,11566,1,"2016-08-30 21:25:58","2016-08-30 21:25:58"
3250,8900,1624,0,8900,2,"2016-08-30 21:25:58","2016-08-30 21:25:58"
3251,8000,1428,0,8000,2,"2016-08-30 21:25:58","2016-08-30 21:25:58"
3252,9900,1634,1634,11534,1,"2016-08-30 21:25:58","2016-08-30 21:25:58"
3253,9900,1579,1579,11479,1,"2016-08-30 21:25:58","2016-08-30 21:25:58"
3254,5000,1356,1356,6356,1,"2016-08-30 21:25:58","2016-08-30 21:25:58"
3255,4000,1310,1310,5310,1,"2016-08-30 21:25:58","2016-08-30 21:25:58"
3256,8500,1599,0,8500,2,"2016-08-30 21:25:58","2016-08-30 21:25:58"
3257,8900,1549,1549,10449,2,"2016-08-30 21:25:58","2016-08-30 21:25:58"
3258,4000,1226,1226,5226,1,"2016-08-30 21:25:59","2016-08-30 21:25:59"
3259,7000,1465,1465,8465,1,"2016-08-30 21:25:59","2016-08-30 21:25:59"
3260,8900,1568,1568,10468,1,"2016-08-30 21:25:59","2016-08-30 21:25:59"
3261,7000,1355,1355,8355,2,"2016-08-30 21:25:59","2016-08-30 21:25:59"
3262,4000,1250,1250,5250,1,"2016-08-30 21:25:59","2016-08-30 21:25:59"
3263,9900,1611,1611,11511,1,"2016-08-30 21:25:59","2016-08-30 21:25:59"
3264,8000,1471,1471,9471,2,"2016-08-30 21:25:59","2016-08-30 21:25:59"
3265,8000,1585,1585,9585,1,"2016-08-30 21:25:59","2016-08-30 21:25:59"
3266,4000,1265,1265,5265,1,"2016-08-30 21:25:59","2016-08-30 21:25:59"
3267,7000,1367,1367,8367,1,"2016-08-30 21:25:59","2016-08-30 21:25:59"
3268,8000,1521,0,8000,2,"2016-08-30 21:25:59","2016-08-30 21:25:59"
3269,8900,1469,1469,10369,2,"2016-08-30 21:25:59","2016-08-30 21:25:59"
3270,8900,1593,0,8900,2,"2016-08-30 21:25:59","2016-08-30 21:25:59"
3271,5000,1365,1365,6365,2,"2016-08-30 21:25:59","2016-08-30 21:25:59"
3272,9500,1497,1497,10997,1,"2016-08-30 21:25:59","2016-08-30 21:25:59"
3273,4000,1277,1277,5277,1,"2016-08-30 21:25:59","2016-08-30 21:25:59"
3274,9900,1638,1638,11538,1,"2016-08-30 21:25:59","2016-08-30 21:25:59"
3275,8000,1441,1441,9441,2,"2016-08-30 21:25:59","2016-08-30 21:25:59"
3276,8000,1491,0,8000,2,"2016-08-30 21:25:59","2016-08-30 21:25:59"
3277,8500,1509,0,8500,2,"2016-08-30 21:25:59","2016-08-30 21:25:59"
3278,9500,1609,1609,11109,1,"2016-08-30 21:25:59","2016-08-30 21:25:59"
3279,4000,1381,1381,5381,2,"2016-08-30 21:25:59","2016-08-30 21:25:59"
3280,8000,1441,0,8000,2,"2016-08-30 21:25:59","2016-08-30 21:25:59"
3281,4000,1290,1290,5290,1,"2016-08-30 21:25:59","2016-08-30 21:25:59"
3282,9900,1516,1516,11416,1,"2016-08-30 21:25:59","2016-08-30 21:25:59"
3283,8000,1579,0,8000,2,"2016-08-30 21:25:59","2016-08-30 21:25:59"
3284,5000,1254,1254,6254,1,"2016-08-30 21:25:59","2016-08-30 21:25:59"
3285,8500,1451,1451,9951,1,"2016-08-30 21:25:59","2016-08-30 21:25:59"
3286,5000,1289,1289,6289,1,"2016-08-30 21:25:59","2016-08-30 21:25:59"
3287,9000,1641,1641,10641,1,"2016-08-30 21:25:59","2016-08-30 21:25:59"
3288,8000,1437,0,8000,2,"2016-08-30 21:25:59","2016-08-30 21:25:59"
3289,8000,1582,1582,9582,1,"2016-08-30 21:25:59","2016-08-30 21:25:59"
3290,4000,1243,1243,5243,1,"2016-08-30 21:25:59","2016-08-30 21:25:59"
3291,8000,1457,1457,9457,2,"2016-08-30 21:25:59","2016-08-30 21:25:59"
3292,8000,1547,0,8000,2,"2016-08-30 21:25:59","2016-08-30 21:25:59"
3293,8000,1469,0,8000,2,"2016-08-30 21:25:59","2016-08-30 21:25:59"
3294,9000,1499,0,9000,2,"2016-08-30 21:25:59","2016-08-30 21:25:59"
3295,9900,1606,1606,11506,2,"2016-08-30 21:25:59","2016-08-30 21:25:59"
3296,8000,1415,0,8000,2,"2016-08-30 21:25:59","2016-08-30 21:25:59"
3297,6000,1454,1454,7454,1,"2016-08-30 21:25:59","2016-08-30 21:25:59"
3298,8000,1527,1527,9527,2,"2016-08-30 21:25:59","2016-08-30 21:25:59"
3299,8000,1573,0,8000,2,"2016-08-30 21:25:59","2016-08-30 21:25:59"
3300,9900,1500,1500,11400,1,"2016-08-30 21:25:59","2016-08-30 21:25:59"
3301,8000,1476,0,8000,2,"2016-08-30 21:25:59","2016-08-30 21:25:59"
3302,5000,1267,1267,6267,2,"2016-08-30 21:25:59","2016-08-30 21:25:59"
3303,8000,1420,1420,9420,1,"2016-08-30 21:25:59","2016-08-30 21:25:59"
3304,8500,1494,1494,9994,1,"2016-08-30 21:25:59","2016-08-30 21:25:59"
3305,8500,1429,0,8500,2,"2016-08-30 21:25:59","2016-08-30 21:25:59"
3306,8500,1470,1470,9970,1,"2016-08-30 21:25:59","2016-08-30 21:25:59"
3307,8500,1619,1619,10119,1,"2016-08-30 21:25:59","2016-08-30 21:25:59"
3308,5000,1390,1390,6390,1,"2016-08-30 21:25:59","2016-08-30 21:25:59"
3309,5000,1425,1425,6425,1,"2016-08-30 21:25:59","2016-08-30 21:25:59"
3310,8900,1636,1636,10536,2,"2016-08-30 21:25:59","2016-08-30 21:25:59"
3311,8000,1445,0,8000,2,"2016-08-30 21:25:59","2016-08-30 21:25:59"
3312,9500,1507,1507,11007,1,"2016-08-30 21:25:59","2016-08-30 21:25:59"
3313,8000,1420,1420,9420,1,"2016-08-30 21:25:59","2016-08-30 21:25:59"
3314,5000,1448,1448,6448,2,"2016-08-30 21:25:59","2016-08-30 21:25:59"
3315,8000,1506,0,8000,2,"2016-08-30 21:25:59","2016-08-30 21:25:59"
3316,6000,1306,1306,7306,1,"2016-08-30 21:25:59","2016-08-30 21:25:59"
3317,8000,1520,1520,9520,1,"2016-08-30 21:25:59","2016-08-30 21:25:59"
3318,8500,1601,0,8500,2,"2016-08-30 21:25:59","2016-08-30 21:25:59"
3319,8500,1588,0,8500,2,"2016-08-30 21:25:59","2016-08-30 21:25:59"
3320,8000,1568,0,8000,2,"2016-08-30 21:25:59","2016-08-30 21:25:59"
3321,9900,1647,1647,11547,1,"2016-08-30 21:25:59","2016-08-30 21:25:59"
3322,8900,1494,0,8900,2,"2016-08-30 21:25:59","2016-08-30 21:25:59"
3323,5000,1446,1446,6446,1,"2016-08-30 21:25:59","2016-08-30 21:25:59"
3324,9500,1510,1510,11010,1,"2016-08-30 21:25:59","2016-08-30 21:25:59"
3325,8500,1439,0,8500,2,"2016-08-30 21:25:59","2016-08-30 21:25:59"
3326,8500,1567,0,8500,2,"2016-08-30 21:25:59","2016-08-30 21:25:59"
3327,7000,1363,1363,8363,2,"2016-08-30 21:25:59","2016-08-30 21:25:59"
3328,8900,1489,1489,10389,1,"2016-08-30 21:25:59","2016-08-30 21:25:59"
3329,6000,1337,1337,7337,2,"2016-08-30 21:25:59","2016-08-30 21:25:59"
3330,8900,1471,1471,10371,2,"2016-08-30 21:25:59","2016-08-30 21:25:59"
3331,8000,1444,1444,9444,2,"2016-08-30 21:25:59","2016-08-30 21:25:59"
3332,8500,1433,0,8500,2,"2016-08-30 21:25:59","2016-08-30 21:25:59"
3333,8500,1533,1533,10033,1,"2016-08-30 21:25:59","2016-08-30 21:25:59"
3334,5000,1419,1419,6419,1,"2016-08-30 21:25:59","2016-08-30 21:25:59"
3335,8000,1537,1537,9537,2,"2016-08-30 21:25:59","2016-08-30 21:25:59"
3336,5000,1347,1347,6347,2,"2016-08-30 21:25:59","2016-08-30 21:25:59"
3337,8500,1519,0,8500,2,"2016-08-30 21:25:59","2016-08-30 21:25:59"
3338,8000,1473,1473,9473,1,"2016-08-30 21:25:59","2016-08-30 21:25:59"
3339,5000,1401,1401,6401,1,"2016-08-30 21:25:59","2016-08-30 21:25:59"
3340,9500,1571,1571,11071,1,"2016-08-30 21:25:59","2016-08-30 21:25:59"
3341,9900,1647,1647,11547,1,"2016-08-30 21:25:59","2016-08-30 21:25:59"
3342,8500,1499,1499,9999,1,"2016-08-30 21:25:59","2016-08-30 21:25:59"
3343,4000,1308,1308,5308,1,"2016-08-30 21:25:59","2016-08-30 21:25:59"
3344,9000,1521,1521,10521,1,"2016-08-30 21:25:59","2016-08-30 21:25:59"
3345,4000,1270,1270,5270,1,"2016-08-30 21:25:59","2016-08-30 21:25:59"
3346,5000,1345,1345,6345,2,"2016-08-30 21:25:59","2016-08-30 21:25:59"
3347,8000,1436,1436,9436,1,"2016-08-30 21:25:59","2016-08-30 21:25:59"
3348,9500,1576,1576,11076,1,"2016-08-30 21:25:59","2016-08-30 21:25:59"
3349,9900,1628,0,9900,2,"2016-08-30 21:25:59","2016-08-30 21:25:59"
3350,7000,1545,1545,8545,1,"2016-08-30 21:25:59","2016-08-30 21:25:59"
3351,9900,1693,1693,11593,1,"2016-08-30 21:25:59","2016-08-30 21:25:59"
3352,9900,1611,0,9900,2,"2016-08-30 21:25:59","2016-08-30 21:25:59"
3353,8900,1598,0,8900,2,"2016-08-30 21:25:59","2016-08-30 21:25:59"
3354,9000,1460,1460,10460,2,"2016-08-30 21:25:59","2016-08-30 21:25:59"
3355,5000,1322,1322,6322,1,"2016-08-30 21:25:59","2016-08-30 21:25:59"
3356,9900,1693,1693,11593,1,"2016-08-30 21:25:59","2016-08-30 21:25:59"
3357,8500,1566,1566,10066,2,"2016-08-30 21:25:59","2016-08-30 21:25:59"
3358,8000,1540,0,8000,2,"2016-08-30 21:25:59","2016-08-30 21:25:59"
3359,4000,1373,1373,5373,2,"2016-08-30 21:25:59","2016-08-30 21:25:59"
3360,8900,1453,0,8900,2,"2016-08-30 21:25:59","2016-08-30 21:25:59"
3361,8500,1566,1566,10066,1,"2016-08-30 21:25:59","2016-08-30 21:25:59"
3362,8000,1553,0,8000,2,"2016-08-30 21:25:59","2016-08-30 21:25:59"
3363,7000,1517,1517,8517,1,"2016-08-30 21:25:59","2016-08-30 21:25:59"
3364,8900,1511,1511,10411,2,"2016-08-30 21:25:59","2016-08-30 21:25:59"
3365,9900,1641,1641,11541,1,"2016-08-30 21:25:59","2016-08-30 21:25:59"
3366,8000,1437,0,8000,2,"2016-08-30 21:25:59","2016-08-30 21:25:59"
3367,8000,1459,0,8000,2,"2016-08-30 21:25:59","2016-08-30 21:25:59"
3368,8000,1547,1547,9547,2,"2016-08-30 21:25:59","2016-08-30 21:25:59"
3369,8500,1461,1461,9961,1,"2016-08-30 21:25:59","2016-08-30 21:25:59"
3370,4000,1298,1298,5298,1,"2016-08-30 21:25:59","2016-08-30 21:25:59"
3371,5000,1329,1329,6329,1,"2016-08-30 21:25:59","2016-08-30 21:25:59"
3372,9900,1499,1499,11399,1,"2016-08-30 21:25:59","2016-08-30 21:25:59"
3373,9900,1572,1572,11472,1,"2016-08-30 21:25:59","2016-08-30 21:25:59"
3374,5000,1350,1350,6350,2,"2016-08-30 21:25:59","2016-08-30 21:25:59"
3375,8000,1465,0,8000,2,"2016-08-30 21:25:59","2016-08-30 21:25:59"
3376,8500,1523,1523,10023,2,"2016-08-30 21:25:59","2016-08-30 21:25:59"
3377,9500,1670,0,9500,2,"2016-08-30 21:25:59","2016-08-30 21:25:59"
3378,8500,1552,0,8500,2,"2016-08-30 21:25:59","2016-08-30 21:25:59"
3379,5000,1333,1333,6333,1,"2016-08-30 21:25:59","2016-08-30 21:25:59"
3380,5000,1287,1287,6287,2,"2016-08-30 21:25:59","2016-08-30 21:25:59"
3381,9000,1593,0,9000,2,"2016-08-30 21:25:59","2016-08-30 21:25:59"
3382,9900,1637,1637,11537,1,"2016-08-30 21:25:59","2016-08-30 21:25:59"
3383,5000,1335,1335,6335,1,"2016-08-30 21:25:59","2016-08-30 21:25:59"
3384,4000,1307,1307,5307,2,"2016-08-30 21:25:59","2016-08-30 21:25:59"
3385,5000,1434,1434,6434,1,"2016-08-30 21:25:59","2016-08-30 21:25:59"
3386,4000,1358,1358,5358,1,"2016-08-30 21:25:59","2016-08-30 21:25:59"
3387,8000,1576,1576,9576,1,"2016-08-30 21:25:59","2016-08-30 21:25:59"
3388,9900,1615,1615,11515,1,"2016-08-30 21:25:59","2016-08-30 21:25:59"
3389,8000,1581,1581,9581,1,"2016-08-30 21:25:59","2016-08-30 21:25:59"
3390,5000,1375,1375,6375,2,"2016-08-30 21:25:59","2016-08-30 21:25:59"
3391,9900,1509,1509,11409,1,"2016-08-30 21:25:59","2016-08-30 21:25:59"
3392,9000,1534,1534,10534,2,"2016-08-30 21:25:59","2016-08-30 21:25:59"
3393,8500,1520,0,8500,2,"2016-08-30 21:25:59","2016-08-30 21:25:59"
3394,8000,1525,1525,9525,1,"2016-08-30 21:25:59","2016-08-30 21:25:59"
3395,8000,1595,0,8000,2,"2016-08-30 21:25:59","2016-08-30 21:25:59"
3396,8000,1494,0,8000,2,"2016-08-30 21:25:59","2016-08-30 21:25:59"
3397,9900,1655,1655,11555,1,"2016-08-30 21:25:59","2016-08-30 21:25:59"
3398,8900,1637,1637,10537,2,"2016-08-30 21:25:59","2016-08-30 21:25:59"
3399,8000,1444,0,8000,2,"2016-08-30 21:25:59","2016-08-30 21:25:59"
3400,8000,1588,1588,9588,2,"2016-08-30 21:25:59","2016-08-30 21:25:59"
3401,7000,1388,1388,8388,1,"2016-08-30 21:25:59","2016-08-30 21:25:59"
3402,5000,1339,1339,6339,2,"2016-08-30 21:25:59","2016-08-30 21:25:59"
3403,8000,1574,0,8000,2,"2016-08-30 21:25:59","2016-08-30 21:25:59"
3404,8900,1451,1451,10351,2,"2016-08-30 21:25:59","2016-08-30 21:25:59"
3405,8000,1546,0,8000,2,"2016-08-30 21:25:59","2016-08-30 21:25:59"
3406,8000,1403,1403,9403,1,"2016-08-30 21:25:59","2016-08-30 21:25:59"
3407,9500,1668,1668,11168,1,"2016-08-30 21:25:59","2016-08-30 21:25:59"
3408,9900,1587,1587,11487,1,"2016-08-30 21:25:59","2016-08-30 21:25:59"
3409,8500,1500,0,8500,2,"2016-08-30 21:25:59","2016-08-30 21:25:59"
3410,8900,1487,0,8900,2,"2016-08-30 21:25:59","2016-08-30 21:25:59"
3411,9000,1611,0,9000,2,"2016-08-30 21:25:59","2016-08-30 21:25:59"
3412,8000,1487,0,8000,2,"2016-08-30 21:25:59","2016-08-30 21:25:59"
3413,8000,1586,0,8000,2,"2016-08-30 21:25:59","2016-08-30 21:25:59"
3414,9900,1586,1586,11486,1,"2016-08-30 21:25:59","2016-08-30 21:25:59"
3415,9500,1660,1660,11160,1,"2016-08-30 21:25:59","2016-08-30 21:25:59"
3416,8000,1532,0,8000,2,"2016-08-30 21:25:59","2016-08-30 21:25:59"
3417,8500,1500,0,8500,2,"2016-08-30 21:25:59","2016-08-30 21:25:59"
3418,8000,1422,1422,9422,2,"2016-08-30 21:25:59","2016-08-30 21:25:59"
3419,8000,1422,0,8000,2,"2016-08-30 21:25:59","2016-08-30 21:25:59"
3420,8500,1553,1553,10053,1,"2016-08-30 21:25:59","2016-08-30 21:25:59"
3421,8000,1548,0,8000,2,"2016-08-30 21:25:59","2016-08-30 21:25:59"
3422,8500,1504,0,8500,2,"2016-08-30 21:25:59","2016-08-30 21:25:59"
3423,9500,1616,1616,11116,1,"2016-08-30 21:25:59","2016-08-30 21:25:59"
3424,8000,1540,1540,9540,1,"2016-08-30 21:25:59","2016-08-30 21:25:59"
3425,5000,1324,1324,6324,1,"2016-08-30 21:25:59","2016-08-30 21:25:59"
3426,8900,1456,1456,10356,1,"2016-08-30 21:25:59","2016-08-30 21:25:59"
3427,6000,1394,1394,7394,1,"2016-08-30 21:25:59","2016-08-30 21:25:59"
3428,5000,1387,1387,6387,1,"2016-08-30 21:25:59","2016-08-30 21:25:59"
3429,9000,1487,1487,10487,2,"2016-08-30 21:25:59","2016-08-30 21:25:59"
3430,8500,1454,0,8500,2,"2016-08-30 21:25:59","2016-08-30 21:25:59"
3431,9900,1654,1654,11554,1,"2016-08-30 21:25:59","2016-08-30 21:25:59"
3432,8000,1472,1472,9472,1,"2016-08-30 21:25:59","2016-08-30 21:25:59"
3433,8500,1511,0,8500,2,"2016-08-30 21:25:59","2016-08-30 21:25:59"
3434,9500,1597,0,9500,2,"2016-08-30 21:25:59","2016-08-30 21:25:59"
3435,8000,1476,1476,9476,1,"2016-08-30 21:25:59","2016-08-30 21:25:59"
3436,8900,1533,0,8900,2,"2016-08-30 21:25:59","2016-08-30 21:25:59"
3437,8000,1424,1424,9424,1,"2016-08-30 21:25:59","2016-08-30 21:25:59"
3438,9500,1652,1652,11152,1,"2016-08-30 21:25:59","2016-08-30 21:25:59"
3439,5000,1337,1337,6337,1,"2016-08-30 21:25:59","2016-08-30 21:25:59"
3440,8000,1406,1406,9406,1,"2016-08-30 21:25:59","2016-08-30 21:25:59"
3441,4000,1373,1373,5373,1,"2016-08-30 21:25:59","2016-08-30 21:25:59"
3442,9000,1462,1462,10462,1,"2016-08-30 21:25:59","2016-08-30 21:25:59"
3443,8000,1514,0,8000,2,"2016-08-30 21:25:59","2016-08-30 21:25:59"
3444,8500,1501,0,8500,2,"2016-08-30 21:25:59","2016-08-30 21:25:59"
3445,8000,1595,1595,9595,1,"2016-08-30 21:25:59","2016-08-30 21:25:59"
3446,4000,1320,1320,5320,1,"2016-08-30 21:25:59","2016-08-30 21:25:59"
3447,8000,1416,1416,9416,1,"2016-08-30 21:25:59","2016-08-30 21:25:59"
3448,8000,1555,0,8000,2,"2016-08-30 21:25:59","2016-08-30 21:25:59"
3449,4000,1276,1276,5276,1,"2016-08-30 21:25:59","2016-08-30 21:25:59"
3450,5000,1355,1355,6355,2,"2016-08-30 21:25:59","2016-08-30 21:25:59"
3451,8000,1545,1545,9545,2,"2016-08-30 21:25:59","2016-08-30 21:25:59"
3452,8900,1446,1446,10346,1,"2016-08-30 21:25:59","2016-08-30 21:25:59"
3453,9500,1664,1664,11164,1,"2016-08-30 21:25:59","2016-08-30 21:25:59"
3454,8000,1403,1403,9403,1,"2016-08-30 21:25:59","2016-08-30 21:25:59"
3455,5000,1344,1344,6344,1,"2016-08-30 21:25:59","2016-08-30 21:25:59"
3456,5000,1412,1412,6412,1,"2016-08-30 21:25:59","2016-08-30 21:25:59"
3457,8000,1519,0,8000,2,"2016-08-30 21:25:59","2016-08-30 21:25:59"
3458,8500,1477,1477,9977,1,"2016-08-30 21:25:59","2016-08-30 21:25:59"
3459,8900,1562,1562,10462,1,"2016-08-30 21:25:59","2016-08-30 21:25:59"
3460,7000,1439,1439,8439,1,"2016-08-30 21:25:59","2016-08-30 21:25:59"
3461,8000,1533,0,8000,2,"2016-08-30 21:25:59","2016-08-30 21:25:59"
3462,8000,1536,0,8000,2,"2016-08-30 21:25:59","2016-08-30 21:25:59"
3463,7000,1493,1493,8493,1,"2016-08-30 21:25:59","2016-08-30 21:25:59"
3464,8900,1540,0,8900,2,"2016-08-30 21:25:59","2016-08-30 21:25:59"
3465,9900,1639,1639,11539,1,"2016-08-30 21:25:59","2016-08-30 21:25:59"
3466,8500,1609,0,8500,2,"2016-08-30 21:25:59","2016-08-30 21:25:59"
3467,8500,1442,0,8500,2,"2016-08-30 21:25:59","2016-08-30 21:25:59"
3468,9900,1619,1619,11519,1,"2016-08-30 21:25:59","2016-08-30 21:25:59"
3469,8000,1526,0,8000,2,"2016-08-30 21:25:59","2016-08-30 21:25:59"
3470,8900,1643,0,8900,2,"2016-08-30 21:25:59","2016-08-30 21:25:59"
3471,8000,1421,0,8000,2,"2016-08-30 21:25:59","2016-08-30 21:25:59"
3472,8500,1439,0,8500,2,"2016-08-30 21:25:59","2016-08-30 21:25:59"
3473,8000,1548,1548,9548,2,"2016-08-30 21:25:59","2016-08-30 21:25:59"
3474,8000,1404,1404,9404,2,"2016-08-30 21:25:59","2016-08-30 21:25:59"
3475,8500,1474,0,8500,2,"2016-08-30 21:25:59","2016-08-30 21:25:59"
3476,8500,1425,0,8500,2,"2016-08-30 21:25:59","2016-08-30 21:25:59"
3477,8000,1461,0,8000,2,"2016-08-30 21:25:59","2016-08-30 21:25:59"
3478,8000,1504,0,8000,2,"2016-08-30 21:25:59","2016-08-30 21:25:59"
3479,8900,1475,1475,10375,2,"2016-08-30 21:25:59","2016-08-30 21:25:59"
3480,5000,1353,1353,6353,2,"2016-08-30 21:25:59","2016-08-30 21:25:59"
3481,8000,1560,1560,9560,1,"2016-08-30 21:25:59","2016-08-30 21:25:59"
3482,4000,1200,1200,5200,1,"2016-08-30 21:25:59","2016-08-30 21:25:59"
3483,8500,1483,1483,9983,2,"2016-08-30 21:25:59","2016-08-30 21:25:59"
3484,4000,1354,1354,5354,1,"2016-08-30 21:25:59","2016-08-30 21:25:59"
3485,4000,1391,1391,5391,1,"2016-08-30 21:25:59","2016-08-30 21:25:59"
3486,9500,1630,1630,11130,1,"2016-08-30 21:25:59","2016-08-30 21:25:59"
3487,8000,1407,1407,9407,1,"2016-08-30 21:25:59","2016-08-30 21:25:59"
3488,9900,1647,0,9900,2,"2016-08-30 21:25:59","2016-08-30 21:25:59"
3489,8000,1550,0,8000,2,"2016-08-30 21:25:59","2016-08-30 21:25:59"
3490,8000,1504,1504,9504,2,"2016-08-30 21:25:59","2016-08-30 21:25:59"
3491,9000,1492,0,9000,2,"2016-08-30 21:25:59","2016-08-30 21:25:59"
3492,8900,1590,1590,10490,1,"2016-08-30 21:25:59","2016-08-30 21:25:59"
3493,7000,1549,1549,8549,1,"2016-08-30 21:25:59","2016-08-30 21:25:59"
3494,8000,1552,1552,9552,2,"2016-08-30 21:25:59","2016-08-30 21:25:59"
3495,8900,1551,0,8900,2,"2016-08-30 21:25:59","2016-08-30 21:25:59"
3496,8000,1448,1448,9448,1,"2016-08-30 21:25:59","2016-08-30 21:25:59"
3497,7000,1525,1525,8525,1,"2016-08-30 21:25:59","2016-08-30 21:25:59"
3498,7000,1446,1446,8446,2,"2016-08-30 21:25:59","2016-08-30 21:25:59"
3499,8500,1492,0,8500,2,"2016-08-30 21:25:59","2016-08-30 21:25:59"
3500,4000,1262,1262,5262,1,"2016-08-30 21:25:59","2016-08-30 21:25:59"
3501,8000,1462,1462,9462,1,"2016-08-30 21:25:59","2016-08-30 21:25:59"
3502,9000,1630,1630,10630,1,"2016-08-30 21:25:59","2016-08-30 21:25:59"
3503,8900,1478,0,8900,2,"2016-08-30 21:25:59","2016-08-30 21:25:59"
3504,9500,1645,0,9500,2,"2016-08-30 21:25:59","2016-08-30 21:25:59"
3505,8500,1460,0,8500,2,"2016-08-30 21:25:59","2016-08-30 21:25:59"
3506,8000,1440,0,8000,2,"2016-08-30 21:25:59","2016-08-30 21:25:59"
3507,8500,1573,0,8500,2,"2016-08-30 21:25:59","2016-08-30 21:25:59"
3508,8900,1467,0,8900,2,"2016-08-30 21:25:59","2016-08-30 21:25:59"
3509,8900,1496,0,8900,2,"2016-08-30 21:25:59","2016-08-30 21:25:59"
3510,8500,1541,1541,10041,2,"2016-08-30 21:25:59","2016-08-30 21:25:59"
3511,8000,1485,0,8000,2,"2016-08-30 21:25:59","2016-08-30 21:25:59"
3512,5000,1349,1349,6349,2,"2016-08-30 21:25:59","2016-08-30 21:25:59"
3513,4000,1348,1348,5348,1,"2016-08-30 21:25:59","2016-08-30 21:25:59"
3514,8000,1572,1572,9572,1,"2016-08-30 21:25:59","2016-08-30 21:25:59"
3515,8000,1525,0,8000,2,"2016-08-30 21:25:59","2016-08-30 21:25:59"
3516,7000,1445,1445,8445,2,"2016-08-30 21:25:59","2016-08-30 21:25:59"
3517,9000,1646,1646,10646,1,"2016-08-30 21:25:59","2016-08-30 21:25:59"
3518,9900,1679,1679,11579,1,"2016-08-30 21:25:59","2016-08-30 21:25:59"
3519,8900,1486,0,8900,2,"2016-08-30 21:25:59","2016-08-30 21:25:59"
3520,4000,1244,1244,5244,2,"2016-08-30 21:25:59","2016-08-30 21:25:59"
3521,8900,1634,0,8900,2,"2016-08-30 21:25:59","2016-08-30 21:25:59"
3522,4000,1224,1224,5224,1,"2016-08-30 21:25:59","2016-08-30 21:25:59"
3523,8500,1452,1452,9952,2,"2016-08-30 21:25:59","2016-08-30 21:25:59"
3524,8500,1434,0,8500,2,"2016-08-30 21:25:59","2016-08-30 21:25:59"
3525,8500,1523,0,8500,2,"2016-08-30 21:25:59","2016-08-30 21:25:59"
3526,7000,1444,1444,8444,2,"2016-08-30 21:25:59","2016-08-30 21:25:59"
3527,8900,1505,0,8900,2,"2016-08-30 21:25:59","2016-08-30 21:25:59"
3528,9900,1530,0,9900,2,"2016-08-30 21:25:59","2016-08-30 21:25:59"
3529,4000,1396,1396,5396,2,"2016-08-30 21:25:59","2016-08-30 21:25:59"
3530,8000,1497,0,8000,2,"2016-08-30 21:25:59","2016-08-30 21:25:59"
3531,4000,1213,1213,5213,1,"2016-08-30 21:25:59","2016-08-30 21:25:59"
3532,9900,1498,1498,11398,1,"2016-08-30 21:25:59","2016-08-30 21:25:59"
3533,9000,1486,1486,10486,1,"2016-08-30 21:25:59","2016-08-30 21:25:59"
3534,9900,1648,1648,11548,1,"2016-08-30 21:25:59","2016-08-30 21:25:59"
3535,5000,1270,1270,6270,2,"2016-08-30 21:25:59","2016-08-30 21:25:59"
3536,8500,1614,0,8500,2,"2016-08-30 21:25:59","2016-08-30 21:25:59"
3537,8900,1500,0,8900,2,"2016-08-30 21:25:59","2016-08-30 21:25:59"
3538,7000,1510,1510,8510,1,"2016-08-30 21:25:59","2016-08-30 21:25:59"
3539,6000,1379,1379,7379,1,"2016-08-30 21:25:59","2016-08-30 21:25:59"
3540,8000,1488,1488,9488,1,"2016-08-30 21:25:59","2016-08-30 21:25:59"
3541,5000,1325,1325,6325,1,"2016-08-30 21:25:59","2016-08-30 21:25:59"
3542,8000,1424,0,8000,2,"2016-08-30 21:25:59","2016-08-30 21:25:59"
3543,8000,1419,0,8000,2,"2016-08-30 21:25:59","2016-08-30 21:25:59"
3544,8900,1571,1571,10471,2,"2016-08-30 21:25:59","2016-08-30 21:25:59"
3545,8900,1459,0,8900,2,"2016-08-30 21:25:59","2016-08-30 21:25:59"
3546,7000,1508,1508,8508,1,"2016-08-30 21:25:59","2016-08-30 21:25:59"
3547,8000,1528,0,8000,2,"2016-08-30 21:25:59","2016-08-30 21:25:59"
3548,8500,1496,1496,9996,2,"2016-08-30 21:25:59","2016-08-30 21:25:59"
3549,8000,1447,1447,9447,1,"2016-08-30 21:25:59","2016-08-30 21:25:59"
3550,9900,1577,1577,11477,1,"2016-08-30 21:25:59","2016-08-30 21:25:59"
3551,9900,1661,0,9900,2,"2016-08-30 21:25:59","2016-08-30 21:25:59"
3552,8000,1463,1463,9463,1,"2016-08-30 21:25:59","2016-08-30 21:25:59"
3553,9900,1496,1496,11396,1,"2016-08-30 21:25:59","2016-08-30 21:25:59"
3554,8000,1557,1557,9557,1,"2016-08-30 21:25:59","2016-08-30 21:25:59"
3555,8500,1539,0,8500,2,"2016-08-30 21:25:59","2016-08-30 21:25:59"
3556,7000,1371,1371,8371,2,"2016-08-30 21:25:59","2016-08-30 21:25:59"
3557,4000,1211,1211,5211,2,"2016-08-30 21:25:59","2016-08-30 21:25:59"
3558,8000,1500,0,8000,2,"2016-08-30 21:25:59","2016-08-30 21:25:59"
3559,4000,1263,1263,5263,1,"2016-08-30 21:25:59","2016-08-30 21:25:59"
3560,4000,1286,1286,5286,1,"2016-08-30 21:25:59","2016-08-30 21:25:59"
3561,8000,1404,0,8000,2,"2016-08-30 21:25:59","2016-08-30 21:25:59"
3562,8000,1547,0,8000,2,"2016-08-30 21:25:59","2016-08-30 21:25:59"
3563,9000,1469,1469,10469,1,"2016-08-30 21:25:59","2016-08-30 21:25:59"
3564,5000,1325,1325,6325,1,"2016-08-30 21:25:59","2016-08-30 21:25:59"
3565,5000,1311,1311,6311,1,"2016-08-30 21:25:59","2016-08-30 21:25:59"
3566,8000,1431,1431,9431,1,"2016-08-30 21:25:59","2016-08-30 21:25:59"
3567,8000,1513,1513,9513,2,"2016-08-30 21:25:59","2016-08-30 21:25:59"
3568,7000,1515,1515,8515,1,"2016-08-30 21:25:59","2016-08-30 21:25:59"
3569,6000,1394,1394,7394,2,"2016-08-30 21:25:59","2016-08-30 21:25:59"
3570,5000,1283,1283,6283,1,"2016-08-30 21:25:59","2016-08-30 21:25:59"
3571,9900,1689,1689,11589,1,"2016-08-30 21:26:00","2016-08-30 21:26:00"
3572,8500,1451,1451,9951,2,"2016-08-30 21:26:00","2016-08-30 21:26:00"
3573,5000,1271,1271,6271,1,"2016-08-30 21:26:00","2016-08-30 21:26:00"
3574,8900,1473,1473,10373,1,"2016-08-30 21:26:00","2016-08-30 21:26:00"
3575,8000,1405,1405,9405,1,"2016-08-30 21:26:00","2016-08-30 21:26:00"
3576,9500,1622,0,9500,2,"2016-08-30 21:26:00","2016-08-30 21:26:00"
3577,8000,1499,1499,9499,1,"2016-08-30 21:26:00","2016-08-30 21:26:00"
3578,4000,1378,1378,5378,2,"2016-08-30 21:26:00","2016-08-30 21:26:00"
3579,8500,1545,0,8500,2,"2016-08-30 21:26:00","2016-08-30 21:26:00"
3580,9900,1623,0,9900,2,"2016-08-30 21:26:00","2016-08-30 21:26:00"
3581,9000,1595,1595,10595,1,"2016-08-30 21:26:00","2016-08-30 21:26:00"
3582,4000,1214,1214,5214,2,"2016-08-30 21:26:00","2016-08-30 21:26:00"
3583,9000,1484,1484,10484,1,"2016-08-30 21:26:00","2016-08-30 21:26:00"
3584,8000,1508,1508,9508,2,"2016-08-30 21:26:00","2016-08-30 21:26:00"
3585,4000,1343,1343,5343,1,"2016-08-30 21:26:00","2016-08-30 21:26:00"
3586,8500,1462,0,8500,2,"2016-08-30 21:26:00","2016-08-30 21:26:00"
3587,5000,1425,1425,6425,1,"2016-08-30 21:26:00","2016-08-30 21:26:00"
3588,8000,1491,0,8000,2,"2016-08-30 21:26:00","2016-08-30 21:26:00"
3589,4000,1381,1381,5381,1,"2016-08-30 21:26:00","2016-08-30 21:26:00"
3590,8000,1533,1533,9533,2,"2016-08-30 21:26:00","2016-08-30 21:26:00"
3591,8900,1479,0,8900,2,"2016-08-30 21:26:00","2016-08-30 21:26:00"
3592,5000,1326,1326,6326,2,"2016-08-30 21:26:00","2016-08-30 21:26:00"
3593,8500,1474,1474,9974,2,"2016-08-30 21:26:00","2016-08-30 21:26:00"
3594,8900,1551,0,8900,2,"2016-08-30 21:26:00","2016-08-30 21:26:00"
3595,8000,1585,1585,9585,1,"2016-08-30 21:26:00","2016-08-30 21:26:00"
3596,9900,1616,1616,11516,2,"2016-08-30 21:26:00","2016-08-30 21:26:00"
3597,8000,1454,1454,9454,1,"2016-08-30 21:26:00","2016-08-30 21:26:00"
3598,9500,1518,0,9500,2,"2016-08-30 21:26:00","2016-08-30 21:26:00"
3599,5000,1423,1423,6423,1,"2016-08-30 21:26:00","2016-08-30 21:26:00"
3600,8000,1440,0,8000,2,"2016-08-30 21:26:00","2016-08-30 21:26:00"
3601,8000,1593,1593,9593,1,"2016-08-30 21:26:00","2016-08-30 21:26:00"
3602,8500,1455,0,8500,2,"2016-08-30 21:26:00","2016-08-30 21:26:00"
3603,5000,1377,1377,6377,1,"2016-08-30 21:26:00","2016-08-30 21:26:00"
3604,8000,1476,1476,9476,1,"2016-08-30 21:26:00","2016-08-30 21:26:00"
3605,9900,1631,0,9900,2,"2016-08-30 21:26:00","2016-08-30 21:26:00"
3606,8900,1570,1570,10470,2,"2016-08-30 21:26:00","2016-08-30 21:26:00"
3607,5000,1372,1372,6372,1,"2016-08-30 21:26:00","2016-08-30 21:26:00"
3608,8000,1407,0,8000,2,"2016-08-30 21:26:00","2016-08-30 21:26:00"
3609,4000,1341,1341,5341,1,"2016-08-30 21:26:00","2016-08-30 21:26:00"
3610,9900,1633,1633,11533,1,"2016-08-30 21:26:00","2016-08-30 21:26:00"
3611,9900,1657,1657,11557,1,"2016-08-30 21:26:00","2016-08-30 21:26:00"
3612,8900,1512,1512,10412,2,"2016-08-30 21:26:00","2016-08-30 21:26:00"
3613,8500,1594,1594,10094,2,"2016-08-30 21:26:00","2016-08-30 21:26:00"
3614,5000,1330,1330,6330,1,"2016-08-30 21:26:00","2016-08-30 21:26:00"
3615,4000,1357,1357,5357,2,"2016-08-30 21:26:00","2016-08-30 21:26:00"
3616,8000,1579,1579,9579,2,"2016-08-30 21:26:00","2016-08-30 21:26:00"
3617,6000,1372,1372,7372,1,"2016-08-30 21:26:00","2016-08-30 21:26:00"
3618,8000,1445,0,8000,2,"2016-08-30 21:26:00","2016-08-30 21:26:00"
3619,8000,1560,0,8000,2,"2016-08-30 21:26:00","2016-08-30 21:26:00"
3620,8000,1441,1441,9441,2,"2016-08-30 21:26:00","2016-08-30 21:26:00"
3621,8500,1553,1553,10053,1,"2016-08-30 21:26:00","2016-08-30 21:26:00"
3622,5000,1403,1403,6403,1,"2016-08-30 21:26:00","2016-08-30 21:26:00"
3623,8500,1586,1586,10086,1,"2016-08-30 21:26:00","2016-08-30 21:26:00"
3624,8500,1526,0,8500,2,"2016-08-30 21:26:00","2016-08-30 21:26:00"
3625,8500,1425,1425,9925,1,"2016-08-30 21:26:00","2016-08-30 21:26:00"
3626,8000,1545,0,8000,2,"2016-08-30 21:26:00","2016-08-30 21:26:00"
3627,8000,1437,0,8000,2,"2016-08-30 21:26:00","2016-08-30 21:26:00"
3628,7000,1413,1413,8413,1,"2016-08-30 21:26:00","2016-08-30 21:26:00"
3629,5000,1318,1318,6318,1,"2016-08-30 21:26:00","2016-08-30 21:26:00"
3630,8000,1554,1554,9554,1,"2016-08-30 21:26:00","2016-08-30 21:26:00"
3631,8900,1585,0,8900,2,"2016-08-30 21:26:00","2016-08-30 21:26:00"
3632,8500,1481,1481,9981,2,"2016-08-30 21:26:00","2016-08-30 21:26:00"
3633,7000,1473,1473,8473,1,"2016-08-30 21:26:00","2016-08-30 21:26:00"
3634,5000,1405,1405,6405,2,"2016-08-30 21:26:00","2016-08-30 21:26:00"
3635,9500,1568,0,9500,2,"2016-08-30 21:26:00","2016-08-30 21:26:00"
3636,8000,1451,1451,9451,2,"2016-08-30 21:26:00","2016-08-30 21:26:00"
3637,8500,1515,1515,10015,1,"2016-08-30 21:26:00","2016-08-30 21:26:00"
3638,8500,1526,1526,10026,1,"2016-08-30 21:26:00","2016-08-30 21:26:00"
3639,9900,1514,1514,11414,1,"2016-08-30 21:26:00","2016-08-30 21:26:00"
3640,8500,1562,0,8500,2,"2016-08-30 21:26:00","2016-08-30 21:26:00"
3641,5000,1279,1279,6279,1,"2016-08-30 21:26:00","2016-08-30 21:26:00"
3642,8000,1454,1454,9454,1,"2016-08-30 21:26:00","2016-08-30 21:26:00"
3643,5000,1321,1321,6321,1,"2016-08-30 21:26:00","2016-08-30 21:26:00"
3644,5000,1312,1312,6312,1,"2016-08-30 21:26:00","2016-08-30 21:26:00"
3645,8000,1556,1556,9556,1,"2016-08-30 21:26:00","2016-08-30 21:26:00"
3646,9900,1628,1628,11528,1,"2016-08-30 21:26:00","2016-08-30 21:26:00"
3647,5000,1348,1348,6348,2,"2016-08-30 21:26:00","2016-08-30 21:26:00"
3648,7000,1359,1359,8359,1,"2016-08-30 21:26:00","2016-08-30 21:26:00"
3649,9900,1581,0,9900,2,"2016-08-30 21:26:00","2016-08-30 21:26:00"
3650,8000,1527,0,8000,2,"2016-08-30 21:26:00","2016-08-30 21:26:00"
3651,8000,1523,1523,9523,1,"2016-08-30 21:26:00","2016-08-30 21:26:00"
3652,5000,1331,1331,6331,1,"2016-08-30 21:26:00","2016-08-30 21:26:00"
3653,8500,1482,0,8500,2,"2016-08-30 21:26:00","2016-08-30 21:26:00"
3654,9500,1574,1574,11074,1,"2016-08-30 21:26:00","2016-08-30 21:26:00"
3655,8900,1515,0,8900,2,"2016-08-30 21:26:00","2016-08-30 21:26:00"
3656,8500,1457,1457,9957,1,"2016-08-30 21:26:00","2016-08-30 21:26:00"
3657,8000,1561,1561,9561,2,"2016-08-30 21:26:00","2016-08-30 21:26:00"
3658,8000,1573,0,8000,2,"2016-08-30 21:26:00","2016-08-30 21:26:00"
3659,4000,1326,1326,5326,1,"2016-08-30 21:26:00","2016-08-30 21:26:00"
3660,8000,1450,0,8000,2,"2016-08-30 21:26:00","2016-08-30 21:26:00"
3661,8500,1430,0,8500,2,"2016-08-30 21:26:00","2016-08-30 21:26:00"
3662,4000,1252,1252,5252,1,"2016-08-30 21:26:00","2016-08-30 21:26:00"
3663,8000,1466,1466,9466,1,"2016-08-30 21:26:00","2016-08-30 21:26:00"
3664,8000,1403,0,8000,2,"2016-08-30 21:26:00","2016-08-30 21:26:00"
3665,9900,1533,1533,11433,1,"2016-08-30 21:26:00","2016-08-30 21:26:00"
3666,5000,1362,1362,6362,2,"2016-08-30 21:26:00","2016-08-30 21:26:00"
3667,8000,1476,0,8000,2,"2016-08-30 21:26:00","2016-08-30 21:26:00"
3668,8500,1552,1552,10052,1,"2016-08-30 21:26:00","2016-08-30 21:26:00"
3669,8900,1562,1562,10462,1,"2016-08-30 21:26:00","2016-08-30 21:26:00"
3670,8900,1636,1636,10536,1,"2016-08-30 21:26:00","2016-08-30 21:26:00"
3671,9900,1516,1516,11416,1,"2016-08-30 21:26:00","2016-08-30 21:26:00"
3672,6000,1335,1335,7335,1,"2016-08-30 21:26:00","2016-08-30 21:26:00"
3673,8000,1456,1456,9456,1,"2016-08-30 21:26:00","2016-08-30 21:26:00"
3674,9500,1596,1596,11096,2,"2016-08-30 21:26:00","2016-08-30 21:26:00"
3675,8500,1495,0,8500,2,"2016-08-30 21:26:00","2016-08-30 21:26:00"
3676,8500,1555,0,8500,2,"2016-08-30 21:26:00","2016-08-30 21:26:00"
3677,4000,1283,1283,5283,1,"2016-08-30 21:26:00","2016-08-30 21:26:00"
3678,8500,1426,1426,9926,2,"2016-08-30 21:26:00","2016-08-30 21:26:00"
3679,8900,1535,0,8900,2,"2016-08-30 21:26:00","2016-08-30 21:26:00"
3680,8500,1436,0,8500,2,"2016-08-30 21:26:00","2016-08-30 21:26:00"
3681,4000,1394,1394,5394,1,"2016-08-30 21:26:00","2016-08-30 21:26:00"
3682,8000,1463,0,8000,2,"2016-08-30 21:26:00","2016-08-30 21:26:00"
3683,9900,1617,1617,11517,1,"2016-08-30 21:26:00","2016-08-30 21:26:00"
3684,9900,1616,0,9900,2,"2016-08-30 21:26:00","2016-08-30 21:26:00"
3685,8500,1518,1518,10018,1,"2016-08-30 21:26:00","2016-08-30 21:26:00"
3686,4000,1352,1352,5352,1,"2016-08-30 21:26:00","2016-08-30 21:26:00"
3687,5000,1387,1387,6387,1,"2016-08-30 21:26:00","2016-08-30 21:26:00"
3688,6000,1361,1361,7361,1,"2016-08-30 21:26:00","2016-08-30 21:26:00"
3689,8000,1482,1482,9482,1,"2016-08-30 21:26:00","2016-08-30 21:26:00"
3690,8900,1492,1492,10392,1,"2016-08-30 21:26:00","2016-08-30 21:26:00"
3691,4000,1393,1393,5393,2,"2016-08-30 21:26:00","2016-08-30 21:26:00"
3692,8900,1583,0,8900,2,"2016-08-30 21:26:00","2016-08-30 21:26:00"
3693,9500,1512,1512,11012,1,"2016-08-30 21:26:00","2016-08-30 21:26:00"
3694,8900,1596,0,8900,2,"2016-08-30 21:26:00","2016-08-30 21:26:00"
3695,8000,1405,1405,9405,1,"2016-08-30 21:26:00","2016-08-30 21:26:00"
3696,8000,1437,0,8000,2,"2016-08-30 21:26:00","2016-08-30 21:26:00"
3697,8000,1407,1407,9407,1,"2016-08-30 21:26:00","2016-08-30 21:26:00"
3698,8500,1608,0,8500,2,"2016-08-30 21:26:00","2016-08-30 21:26:00"
3699,4000,1380,1380,5380,1,"2016-08-30 21:26:00","2016-08-30 21:26:00"
3700,8500,1464,0,8500,2,"2016-08-30 21:26:00","2016-08-30 21:26:00"
3701,8000,1451,1451,9451,2,"2016-08-30 21:26:00","2016-08-30 21:26:00"
3702,4000,1228,1228,5228,1,"2016-08-30 21:26:00","2016-08-30 21:26:00"
3703,4000,1207,1207,5207,2,"2016-08-30 21:26:00","2016-08-30 21:26:00"
3704,8000,1520,1520,9520,1,"2016-08-30 21:26:00","2016-08-30 21:26:00"
3705,8500,1564,1564,10064,1,"2016-08-30 21:26:00","2016-08-30 21:26:00"
3706,8000,1534,0,8000,2,"2016-08-30 21:26:00","2016-08-30 21:26:00"
3707,9900,1651,1651,11551,1,"2016-08-30 21:26:00","2016-08-30 21:26:00"
3708,7000,1461,1461,8461,1,"2016-08-30 21:26:00","2016-08-30 21:26:00"
3709,8900,1564,0,8900,2,"2016-08-30 21:26:00","2016-08-30 21:26:00"
3710,9500,1672,1672,11172,1,"2016-08-30 21:26:00","2016-08-30 21:26:00"
3711,8900,1576,1576,10476,1,"2016-08-30 21:26:00","2016-08-30 21:26:00"
3712,9900,1592,1592,11492,1,"2016-08-30 21:26:00","2016-08-30 21:26:00"
3713,4000,1350,1350,5350,1,"2016-08-30 21:26:00","2016-08-30 21:26:00"
3714,4000,1204,1204,5204,2,"2016-08-30 21:26:00","2016-08-30 21:26:00"
3715,7000,1383,1383,8383,1,"2016-08-30 21:26:00","2016-08-30 21:26:00"
3716,4000,1213,1213,5213,2,"2016-08-30 21:26:00","2016-08-30 21:26:00"
3717,6000,1390,1390,7390,1,"2016-08-30 21:26:00","2016-08-30 21:26:00"
3718,5000,1340,1340,6340,2,"2016-08-30 21:26:00","2016-08-30 21:26:00"
3719,8000,1567,1567,9567,1,"2016-08-30 21:26:00","2016-08-30 21:26:00"
3720,8000,1516,1516,9516,1,"2016-08-30 21:26:00","2016-08-30 21:26:00"
3721,8900,1456,1456,10356,1,"2016-08-30 21:26:00","2016-08-30 21:26:00"
3722,8000,1508,0,8000,2,"2016-08-30 21:26:00","2016-08-30 21:26:00"
3723,8000,1433,1433,9433,2,"2016-08-30 21:26:00","2016-08-30 21:26:00"
3724,8000,1596,0,8000,2,"2016-08-30 21:26:00","2016-08-30 21:26:00"
3725,8000,1406,0,8000,2,"2016-08-30 21:26:00","2016-08-30 21:26:00"
3726,5000,1289,1289,6289,1,"2016-08-30 21:26:00","2016-08-30 21:26:00"
3727,9900,1634,1634,11534,1,"2016-08-30 21:26:00","2016-08-30 21:26:00"
3728,9000,1649,1649,10649,1,"2016-08-30 21:26:00","2016-08-30 21:26:00"
3729,8900,1620,1620,10520,1,"2016-08-30 21:26:00","2016-08-30 21:26:00"
3730,8000,1535,0,8000,2,"2016-08-30 21:26:00","2016-08-30 21:26:00"
3731,8900,1632,0,8900,2,"2016-08-30 21:26:00","2016-08-30 21:26:00"
3732,7000,1379,1379,8379,1,"2016-08-30 21:26:00","2016-08-30 21:26:00"
3733,8000,1582,1582,9582,1,"2016-08-30 21:26:00","2016-08-30 21:26:00"
3734,8500,1580,0,8500,2,"2016-08-30 21:26:00","2016-08-30 21:26:00"
3735,8000,1594,1594,9594,2,"2016-08-30 21:26:00","2016-08-30 21:26:00"
3736,8900,1597,1597,10497,2,"2016-08-30 21:26:00","2016-08-30 21:26:00"
3737,7000,1535,1535,8535,2,"2016-08-30 21:26:00","2016-08-30 21:26:00"
3738,8000,1523,1523,9523,1,"2016-08-30 21:26:00","2016-08-30 21:26:00"
3739,6000,1318,1318,7318,1,"2016-08-30 21:26:00","2016-08-30 21:26:00"
3740,8900,1592,1592,10492,1,"2016-08-30 21:26:00","2016-08-30 21:26:00"
3741,8900,1500,0,8900,2,"2016-08-30 21:26:00","2016-08-30 21:26:00"
3742,8000,1460,0,8000,2,"2016-08-30 21:26:00","2016-08-30 21:26:00"
3743,8500,1482,1482,9982,1,"2016-08-30 21:26:00","2016-08-30 21:26:00"
3744,9000,1490,1490,10490,1,"2016-08-30 21:26:00","2016-08-30 21:26:00"
3745,8000,1402,1402,9402,1,"2016-08-30 21:26:00","2016-08-30 21:26:00"
3746,5000,1326,1326,6326,2,"2016-08-30 21:26:00","2016-08-30 21:26:00"
3747,8000,1565,1565,9565,2,"2016-08-30 21:26:00","2016-08-30 21:26:00"
3748,8000,1520,0,8000,2,"2016-08-30 21:26:00","2016-08-30 21:26:00"
3749,8500,1585,0,8500,2,"2016-08-30 21:26:00","2016-08-30 21:26:00"
3750,8500,1441,0,8500,2,"2016-08-30 21:26:00","2016-08-30 21:26:00"
3751,8500,1452,1452,9952,2,"2016-08-30 21:26:00","2016-08-30 21:26:00"
3752,8000,1434,1434,9434,2,"2016-08-30 21:26:00","2016-08-30 21:26:00"
3753,9500,1569,0,9500,2,"2016-08-30 21:26:00","2016-08-30 21:26:00"
3754,8900,1617,0,8900,2,"2016-08-30 21:26:00","2016-08-30 21:26:00"
3755,4000,1265,1265,5265,2,"2016-08-30 21:26:00","2016-08-30 21:26:00"
3756,8500,1470,0,8500,2,"2016-08-30 21:26:00","2016-08-30 21:26:00"
3757,8900,1628,1628,10528,2,"2016-08-30 21:26:00","2016-08-30 21:26:00"
3758,4000,1243,1243,5243,2,"2016-08-30 21:26:00","2016-08-30 21:26:00"
3759,8000,1520,0,8000,2,"2016-08-30 21:26:00","2016-08-30 21:26:00"
3760,8500,1502,0,8500,2,"2016-08-30 21:26:00","2016-08-30 21:26:00"
3761,7000,1398,1398,8398,1,"2016-08-30 21:26:00","2016-08-30 21:26:00"
3762,9500,1642,1642,11142,2,"2016-08-30 21:26:00","2016-08-30 21:26:00"
3763,8000,1461,0,8000,2,"2016-08-30 21:26:00","2016-08-30 21:26:00"
3764,9500,1491,1491,10991,1,"2016-08-30 21:26:00","2016-08-30 21:26:00"
3765,8000,1553,1553,9553,2,"2016-08-30 21:26:00","2016-08-30 21:26:00"
3766,8900,1474,1474,10374,1,"2016-08-30 21:26:00","2016-08-30 21:26:00"
3767,5000,1325,1325,6325,1,"2016-08-30 21:26:00","2016-08-30 21:26:00"
3768,5000,1282,1282,6282,1,"2016-08-30 21:26:00","2016-08-30 21:26:00"
3769,6000,1352,1352,7352,1,"2016-08-30 21:26:00","2016-08-30 21:26:00"
3770,8900,1536,1536,10436,1,"2016-08-30 21:26:00","2016-08-30 21:26:00"
3771,4000,1391,1391,5391,1,"2016-08-30 21:26:00","2016-08-30 21:26:00"
3772,8900,1621,1621,10521,1,"2016-08-30 21:26:00","2016-08-30 21:26:00"
3773,8000,1409,1409,9409,1,"2016-08-30 21:26:00","2016-08-30 21:26:00"
3774,8900,1567,1567,10467,1,"2016-08-30 21:26:00","2016-08-30 21:26:00"
3775,8000,1405,0,8000,2,"2016-08-30 21:26:00","2016-08-30 21:26:00"
3776,8000,1580,1580,9580,2,"2016-08-30 21:26:00","2016-08-30 21:26:00"
3777,8900,1460,1460,10360,1,"2016-08-30 21:26:00","2016-08-30 21:26:00"
3778,4000,1222,1222,5222,2,"2016-08-30 21:26:00","2016-08-30 21:26:00"
3779,6000,1401,1401,7401,1,"2016-08-30 21:26:00","2016-08-30 21:26:00"
3780,8500,1475,1475,9975,1,"2016-08-30 21:26:00","2016-08-30 21:26:00"
3781,8000,1561,1561,9561,2,"2016-08-30 21:26:00","2016-08-30 21:26:00"
3782,8900,1603,0,8900,2,"2016-08-30 21:26:00","2016-08-30 21:26:00"
3783,8500,1584,1584,10084,1,"2016-08-30 21:26:00","2016-08-30 21:26:00"
3784,8900,1468,0,8900,2,"2016-08-30 21:26:00","2016-08-30 21:26:00"
3785,5000,1279,1279,6279,1,"2016-08-30 21:26:00","2016-08-30 21:26:00"
3786,8900,1483,0,8900,2,"2016-08-30 21:26:00","2016-08-30 21:26:00"
3787,9900,1600,0,9900,2,"2016-08-30 21:26:00","2016-08-30 21:26:00"
3788,9900,1579,1579,11479,1,"2016-08-30 21:26:00","2016-08-30 21:26:00"
3789,8000,1540,1540,9540,2,"2016-08-30 21:26:00","2016-08-30 21:26:00"
3790,9000,1587,1587,10587,1,"2016-08-30 21:26:00","2016-08-30 21:26:00"
3791,7000,1441,1441,8441,2,"2016-08-30 21:26:00","2016-08-30 21:26:00"
3792,4000,1349,1349,5349,1,"2016-08-30 21:26:00","2016-08-30 21:26:00"
3793,9900,1600,1600,11500,1,"2016-08-30 21:26:00","2016-08-30 21:26:00"
3794,5000,1440,1440,6440,1,"2016-08-30 21:26:00","2016-08-30 21:26:00"
3795,8000,1426,1426,9426,1,"2016-08-30 21:26:00","2016-08-30 21:26:00"
3796,8900,1613,1613,10513,1,"2016-08-30 21:26:00","2016-08-30 21:26:00"
3797,8000,1416,1416,9416,1,"2016-08-30 21:26:00","2016-08-30 21:26:00"
3798,9000,1649,0,9000,2,"2016-08-30 21:26:00","2016-08-30 21:26:00"
3799,8000,1423,0,8000,2,"2016-08-30 21:26:00","2016-08-30 21:26:00"
3800,4000,1339,1339,5339,1,"2016-08-30 21:26:00","2016-08-30 21:26:00"
3801,4000,1298,1298,5298,1,"2016-08-30 21:26:00","2016-08-30 21:26:00"
3802,5000,1307,1307,6307,2,"2016-08-30 21:26:00","2016-08-30 21:26:00"
3803,8500,1467,0,8500,2,"2016-08-30 21:26:00","2016-08-30 21:26:00"
3804,4000,1251,1251,5251,1,"2016-08-30 21:26:00","2016-08-30 21:26:00"
3805,8500,1510,1510,10010,1,"2016-08-30 21:26:00","2016-08-30 21:26:00"
3806,9900,1586,1586,11486,1,"2016-08-30 21:26:00","2016-08-30 21:26:00"
3807,8500,1542,0,8500,2,"2016-08-30 21:26:00","2016-08-30 21:26:00"
3808,7000,1421,1421,8421,1,"2016-08-30 21:26:00","2016-08-30 21:26:00"
3809,8500,1620,0,8500,2,"2016-08-30 21:26:00","2016-08-30 21:26:00"
3810,9000,1511,1511,10511,1,"2016-08-30 21:26:00","2016-08-30 21:26:00"
3811,4000,1206,1206,5206,1,"2016-08-30 21:26:00","2016-08-30 21:26:00"
3812,8000,1502,1502,9502,1,"2016-08-30 21:26:00","2016-08-30 21:26:00"
3813,8000,1517,0,8000,2,"2016-08-30 21:26:00","2016-08-30 21:26:00"
3814,8900,1553,0,8900,2,"2016-08-30 21:26:00","2016-08-30 21:26:00"
3815,8000,1577,1577,9577,1,"2016-08-30 21:26:00","2016-08-30 21:26:00"
3816,8000,1447,1447,9447,1,"2016-08-30 21:26:00","2016-08-30 21:26:00"
3817,9900,1607,0,9900,2,"2016-08-30 21:26:00","2016-08-30 21:26:00"
3818,9500,1638,1638,11138,1,"2016-08-30 21:26:00","2016-08-30 21:26:00"
3819,9500,1670,1670,11170,2,"2016-08-30 21:26:00","2016-08-30 21:26:00"
3820,8900,1564,1564,10464,1,"2016-08-30 21:26:00","2016-08-30 21:26:00"
3821,9900,1568,1568,11468,1,"2016-08-30 21:26:00","2016-08-30 21:26:00"
3822,8500,1567,0,8500,2,"2016-08-30 21:26:00","2016-08-30 21:26:00"
3823,8000,1421,1421,9421,2,"2016-08-30 21:26:00","2016-08-30 21:26:00"
3824,8000,1432,1432,9432,2,"2016-08-30 21:26:00","2016-08-30 21:26:00"
3825,8900,1510,1510,10410,1,"2016-08-30 21:26:00","2016-08-30 21:26:00"
3826,5000,1399,1399,6399,1,"2016-08-30 21:26:00","2016-08-30 21:26:00"
3827,9000,1644,1644,10644,1,"2016-08-30 21:26:00","2016-08-30 21:26:00"
3828,8900,1447,1447,10347,1,"2016-08-30 21:26:00","2016-08-30 21:26:00"
3829,5000,1388,1388,6388,2,"2016-08-30 21:26:00","2016-08-30 21:26:00"
3830,9900,1515,1515,11415,1,"2016-08-30 21:26:00","2016-08-30 21:26:00"
3831,4000,1270,1270,5270,1,"2016-08-30 21:26:00","2016-08-30 21:26:00"
3832,4000,1380,1380,5380,1,"2016-08-30 21:26:00","2016-08-30 21:26:00"
3833,9500,1597,0,9500,2,"2016-08-30 21:26:00","2016-08-30 21:26:00"
3834,4000,1222,1222,5222,1,"2016-08-30 21:26:00","2016-08-30 21:26:00"
3835,8000,1407,1407,9407,2,"2016-08-30 21:26:00","2016-08-30 21:26:00"
3836,9000,1635,0,9000,2,"2016-08-30 21:26:00","2016-08-30 21:26:00"
3837,8500,1493,1493,9993,2,"2016-08-30 21:26:00","2016-08-30 21:26:00"
3838,8000,1410,0,8000,2,"2016-08-30 21:26:00","2016-08-30 21:26:00"
3839,9900,1541,0,9900,2,"2016-08-30 21:26:00","2016-08-30 21:26:00"
3840,8500,1572,0,8500,2,"2016-08-30 21:26:00","2016-08-30 21:26:00"
3841,8900,1619,1619,10519,1,"2016-08-30 21:26:00","2016-08-30 21:26:00"
3842,5000,1253,1253,6253,2,"2016-08-30 21:26:00","2016-08-30 21:26:00"
3843,8000,1526,1526,9526,1,"2016-08-30 21:26:00","2016-08-30 21:26:00"
3844,8500,1554,1554,10054,1,"2016-08-30 21:26:00","2016-08-30 21:26:00"
3845,8500,1575,0,8500,2,"2016-08-30 21:26:00","2016-08-30 21:26:00"
3846,8900,1641,0,8900,2,"2016-08-30 21:26:00","2016-08-30 21:26:00"
3847,8000,1572,1572,9572,1,"2016-08-30 21:26:00","2016-08-30 21:26:00"
3848,8900,1623,1623,10523,1,"2016-08-30 21:26:00","2016-08-30 21:26:00"
3849,8900,1518,0,8900,2,"2016-08-30 21:26:00","2016-08-30 21:26:00"
3850,9900,1570,1570,11470,1,"2016-08-30 21:26:00","2016-08-30 21:26:00"
3851,8900,1451,1451,10351,2,"2016-08-30 21:26:00","2016-08-30 21:26:00"
3852,9500,1632,0,9500,2,"2016-08-30 21:26:00","2016-08-30 21:26:00"
3853,9000,1539,0,9000,2,"2016-08-30 21:26:00","2016-08-30 21:26:00"
3854,7000,1493,1493,8493,1,"2016-08-30 21:26:00","2016-08-30 21:26:00"
3855,4000,1256,1256,5256,1,"2016-08-30 21:26:00","2016-08-30 21:26:00"
3856,8000,1489,0,8000,2,"2016-08-30 21:26:00","2016-08-30 21:26:00"
3857,5000,1324,1324,6324,1,"2016-08-30 21:26:00","2016-08-30 21:26:00"
3858,8000,1581,0,8000,2,"2016-08-30 21:26:00","2016-08-30 21:26:00"
3859,8000,1545,1545,9545,1,"2016-08-30 21:26:00","2016-08-30 21:26:00"
3860,8500,1450,1450,9950,1,"2016-08-30 21:26:00","2016-08-30 21:26:00"
3861,4000,1337,1337,5337,2,"2016-08-30 21:26:00","2016-08-30 21:26:00"
3862,8000,1577,1577,9577,1,"2016-08-30 21:26:00","2016-08-30 21:26:00"
3863,8500,1465,1465,9965,1,"2016-08-30 21:26:00","2016-08-30 21:26:00"
3864,8900,1541,0,8900,2,"2016-08-30 21:26:00","2016-08-30 21:26:00"
3865,7000,1508,1508,8508,1,"2016-08-30 21:26:00","2016-08-30 21:26:00"
3866,8000,1519,1519,9519,1,"2016-08-30 21:26:00","2016-08-30 21:26:00"
3867,8000,1535,0,8000,2,"2016-08-30 21:26:00","2016-08-30 21:26:00"
3868,8000,1524,1524,9524,2,"2016-08-30 21:26:00","2016-08-30 21:26:00"
3869,7000,1371,1371,8371,1,"2016-08-30 21:26:00","2016-08-30 21:26:00"
3870,7000,1474,1474,8474,1,"2016-08-30 21:26:00","2016-08-30 21:26:00"
3871,4000,1304,1304,5304,1,"2016-08-30 21:26:00","2016-08-30 21:26:00"
3872,8000,1579,1579,9579,2,"2016-08-30 21:26:00","2016-08-30 21:26:00"
3873,8900,1489,1489,10389,1,"2016-08-30 21:26:00","2016-08-30 21:26:00"
3874,8500,1624,0,8500,2,"2016-08-30 21:26:00","2016-08-30 21:26:00"
3875,8000,1525,1525,9525,2,"2016-08-30 21:26:00","2016-08-30 21:26:00"
3876,8900,1593,1593,10493,1,"2016-08-30 21:26:00","2016-08-30 21:26:00"
3877,8900,1449,0,8900,2,"2016-08-30 21:26:00","2016-08-30 21:26:00"
3878,8000,1474,1474,9474,1,"2016-08-30 21:26:00","2016-08-30 21:26:00"
3879,8500,1577,1577,10077,1,"2016-08-30 21:26:00","2016-08-30 21:26:00"
3880,4000,1214,1214,5214,1,"2016-08-30 21:26:00","2016-08-30 21:26:00"
3881,5000,1431,1431,6431,1,"2016-08-30 21:26:00","2016-08-30 21:26:00"
3882,8500,1508,1508,10008,1,"2016-08-30 21:26:00","2016-08-30 21:26:00"
3883,5000,1352,1352,6352,2,"2016-08-30 21:26:00","2016-08-30 21:26:00"
3884,8000,1453,0,8000,2,"2016-08-30 21:26:00","2016-08-30 21:26:00"
3885,4000,1301,1301,5301,1,"2016-08-30 21:26:01","2016-08-30 21:26:01"
3886,8000,1557,1557,9557,1,"2016-08-30 21:26:01","2016-08-30 21:26:01"
3887,4000,1332,1332,5332,2,"2016-08-30 21:26:01","2016-08-30 21:26:01"
3888,9900,1672,0,9900,2,"2016-08-30 21:26:01","2016-08-30 21:26:01"
3889,9900,1616,0,9900,2,"2016-08-30 21:26:01","2016-08-30 21:26:01"
3890,4000,1267,1267,5267,1,"2016-08-30 21:26:01","2016-08-30 21:26:01"
3891,5000,1283,1283,6283,1,"2016-08-30 21:26:01","2016-08-30 21:26:01"
3892,8000,1574,0,8000,2,"2016-08-30 21:26:01","2016-08-30 21:26:01"
3893,8500,1436,1436,9936,1,"2016-08-30 21:26:01","2016-08-30 21:26:01"
3894,8000,1546,1546,9546,2,"2016-08-30 21:26:01","2016-08-30 21:26:01"
3895,9900,1633,0,9900,2,"2016-08-30 21:26:01","2016-08-30 21:26:01"
3896,5000,1359,1359,6359,1,"2016-08-30 21:26:01","2016-08-30 21:26:01"
3897,5000,1378,1378,6378,1,"2016-08-30 21:26:01","2016-08-30 21:26:01"
3898,8900,1598,1598,10498,2,"2016-08-30 21:26:01","2016-08-30 21:26:01"
3899,4000,1341,1341,5341,1,"2016-08-30 21:26:01","2016-08-30 21:26:01"
3900,8500,1514,1514,10014,1,"2016-08-30 21:26:01","2016-08-30 21:26:01"
3901,9900,1668,1668,11568,1,"2016-08-30 21:26:01","2016-08-30 21:26:01"
3902,8000,1523,1523,9523,1,"2016-08-30 21:26:01","2016-08-30 21:26:01"
3903,8000,1450,0,8000,2,"2016-08-30 21:26:01","2016-08-30 21:26:01"
3904,8000,1438,0,8000,2,"2016-08-30 21:26:01","2016-08-30 21:26:01"
3905,8000,1440,0,8000,2,"2016-08-30 21:26:01","2016-08-30 21:26:01"
3906,9500,1514,1514,11014,1,"2016-08-30 21:26:01","2016-08-30 21:26:01"
3907,9500,1648,1648,11148,1,"2016-08-30 21:26:01","2016-08-30 21:26:01"
3908,8000,1469,1469,9469,1,"2016-08-30 21:26:01","2016-08-30 21:26:01"
3909,5000,1346,1346,6346,2,"2016-08-30 21:26:01","2016-08-30 21:26:01"
3910,8000,1435,1435,9435,1,"2016-08-30 21:26:01","2016-08-30 21:26:01"
3911,8500,1486,0,8500,2,"2016-08-30 21:26:01","2016-08-30 21:26:01"
3912,9000,1588,1588,10588,1,"2016-08-30 21:26:01","2016-08-30 21:26:01"
3913,9000,1521,1521,10521,1,"2016-08-30 21:26:01","2016-08-30 21:26:01"
3914,4000,1298,1298,5298,1,"2016-08-30 21:26:01","2016-08-30 21:26:01"
3915,4000,1309,1309,5309,1,"2016-08-30 21:26:01","2016-08-30 21:26:01"
3916,8500,1615,0,8500,2,"2016-08-30 21:26:01","2016-08-30 21:26:01"
3917,8000,1446,1446,9446,2,"2016-08-30 21:26:01","2016-08-30 21:26:01"
3918,8500,1552,0,8500,2,"2016-08-30 21:26:01","2016-08-30 21:26:01"
3919,8000,1423,0,8000,2,"2016-08-30 21:26:01","2016-08-30 21:26:01"
3920,8900,1550,0,8900,2,"2016-08-30 21:26:01","2016-08-30 21:26:01"
3921,8900,1609,1609,10509,1,"2016-08-30 21:26:01","2016-08-30 21:26:01"
3922,8000,1552,1552,9552,1,"2016-08-30 21:26:01","2016-08-30 21:26:01"
3923,9500,1611,1611,11111,1,"2016-08-30 21:26:01","2016-08-30 21:26:01"
3924,9500,1485,1485,10985,1,"2016-08-30 21:26:01","2016-08-30 21:26:01"
3925,8900,1539,0,8900,2,"2016-08-30 21:26:01","2016-08-30 21:26:01"
3926,8000,1415,1415,9415,2,"2016-08-30 21:26:01","2016-08-30 21:26:01"
3927,8900,1611,0,8900,2,"2016-08-30 21:26:01","2016-08-30 21:26:01"
3928,9500,1500,1500,11000,1,"2016-08-30 21:26:01","2016-08-30 21:26:01"
3929,8500,1564,0,8500,2,"2016-08-30 21:26:01","2016-08-30 21:26:01"
3930,4000,1210,1210,5210,1,"2016-08-30 21:26:01","2016-08-30 21:26:01"
3931,4000,1241,1241,5241,2,"2016-08-30 21:26:01","2016-08-30 21:26:01"
3932,8500,1524,1524,10024,2,"2016-08-30 21:26:01","2016-08-30 21:26:01"
3933,7000,1406,1406,8406,1,"2016-08-30 21:26:01","2016-08-30 21:26:01"
3934,8500,1609,1609,10109,2,"2016-08-30 21:26:01","2016-08-30 21:26:01"
3935,5000,1302,1302,6302,2,"2016-08-30 21:26:01","2016-08-30 21:26:01"
3936,8500,1528,1528,10028,1,"2016-08-30 21:26:01","2016-08-30 21:26:01"
3937,8500,1588,1588,10088,2,"2016-08-30 21:26:01","2016-08-30 21:26:01"
3938,4000,1250,1250,5250,1,"2016-08-30 21:26:01","2016-08-30 21:26:01"
3939,8000,1451,1451,9451,1,"2016-08-30 21:26:01","2016-08-30 21:26:01"
3940,6000,1348,1348,7348,1,"2016-08-30 21:26:01","2016-08-30 21:26:01"
3941,5000,1256,1256,6256,1,"2016-08-30 21:26:01","2016-08-30 21:26:01"
3942,4000,1303,1303,5303,1,"2016-08-30 21:26:01","2016-08-30 21:26:01"
3943,8000,1516,0,8000,2,"2016-08-30 21:26:01","2016-08-30 21:26:01"
3944,8000,1563,0,8000,2,"2016-08-30 21:26:01","2016-08-30 21:26:01"
3945,8500,1545,1545,10045,2,"2016-08-30 21:26:01","2016-08-30 21:26:01"
3946,8000,1514,0,8000,2,"2016-08-30 21:26:01","2016-08-30 21:26:01"
3947,6000,1352,1352,7352,1,"2016-08-30 21:26:01","2016-08-30 21:26:01"
3948,4000,1217,1217,5217,1,"2016-08-30 21:26:01","2016-08-30 21:26:01"
3949,9900,1653,1653,11553,2,"2016-08-30 21:26:01","2016-08-30 21:26:01"
3950,4000,1373,1373,5373,2,"2016-08-30 21:26:01","2016-08-30 21:26:01"
3951,9500,1674,1674,11174,1,"2016-08-30 21:26:01","2016-08-30 21:26:01"
3952,5000,1439,1439,6439,2,"2016-08-30 21:26:01","2016-08-30 21:26:01"
3953,9500,1616,0,9500,2,"2016-08-30 21:26:01","2016-08-30 21:26:01"
3954,9500,1622,0,9500,2,"2016-08-30 21:26:01","2016-08-30 21:26:01"
3955,8000,1503,1503,9503,1,"2016-08-30 21:26:01","2016-08-30 21:26:01"
3956,8000,1430,1430,9430,1,"2016-08-30 21:26:01","2016-08-30 21:26:01"
3957,9000,1452,1452,10452,1,"2016-08-30 21:26:01","2016-08-30 21:26:01"
3958,4000,1206,1206,5206,1,"2016-08-30 21:26:01","2016-08-30 21:26:01"
3959,8000,1512,0,8000,2,"2016-08-30 21:26:01","2016-08-30 21:26:01"
3960,9500,1585,1585,11085,2,"2016-08-30 21:26:01","2016-08-30 21:26:01"
3961,8500,1613,0,8500,2,"2016-08-30 21:26:01","2016-08-30 21:26:01"
3962,8900,1612,0,8900,2,"2016-08-30 21:26:01","2016-08-30 21:26:01"
3963,8000,1408,1408,9408,2,"2016-08-30 21:26:01","2016-08-30 21:26:01"
3964,6000,1489,1489,7489,1,"2016-08-30 21:26:01","2016-08-30 21:26:01"
3965,8000,1596,0,8000,2,"2016-08-30 21:26:01","2016-08-30 21:26:01"
3966,8000,1506,1506,9506,1,"2016-08-30 21:26:01","2016-08-30 21:26:01"
3967,8900,1643,1643,10543,1,"2016-08-30 21:26:01","2016-08-30 21:26:01"
3968,9500,1498,1498,10998,1,"2016-08-30 21:26:01","2016-08-30 21:26:01"
3969,5000,1263,1263,6263,1,"2016-08-30 21:26:01","2016-08-30 21:26:01"
3970,9900,1535,1535,11435,1,"2016-08-30 21:26:01","2016-08-30 21:26:01"
3971,9900,1593,1593,11493,1,"2016-08-30 21:26:01","2016-08-30 21:26:01"
3972,8000,1471,0,8000,2,"2016-08-30 21:26:01","2016-08-30 21:26:01"
3973,5000,1257,1257,6257,1,"2016-08-30 21:26:01","2016-08-30 21:26:01"
3974,8900,1544,0,8900,2,"2016-08-30 21:26:01","2016-08-30 21:26:01"
3975,9500,1618,1618,11118,1,"2016-08-30 21:26:01","2016-08-30 21:26:01"
3976,7000,1381,1381,8381,1,"2016-08-30 21:26:01","2016-08-30 21:26:01"
3977,5000,1332,1332,6332,1,"2016-08-30 21:26:01","2016-08-30 21:26:01"
3978,8500,1554,0,8500,2,"2016-08-30 21:26:01","2016-08-30 21:26:01"
3979,8900,1491,0,8900,2,"2016-08-30 21:26:01","2016-08-30 21:26:01"
3980,9000,1535,1535,10535,1,"2016-08-30 21:26:01","2016-08-30 21:26:01"
3981,4000,1345,1345,5345,1,"2016-08-30 21:26:01","2016-08-30 21:26:01"
3982,7000,1417,1417,8417,1,"2016-08-30 21:26:01","2016-08-30 21:26:01"
3983,8900,1548,1548,10448,1,"2016-08-30 21:26:01","2016-08-30 21:26:01"
3984,9500,1553,1553,11053,1,"2016-08-30 21:26:01","2016-08-30 21:26:01"
3985,8500,1455,0,8500,2,"2016-08-30 21:26:01","2016-08-30 21:26:01"
3986,8000,1456,0,8000,2,"2016-08-30 21:26:01","2016-08-30 21:26:01"
3987,8000,1425,1425,9425,1,"2016-08-30 21:26:01","2016-08-30 21:26:01"
3988,4000,1396,1396,5396,2,"2016-08-30 21:26:01","2016-08-30 21:26:01"
3989,7000,1368,1368,8368,1,"2016-08-30 21:26:01","2016-08-30 21:26:01"
3990,8500,1517,1517,10017,2,"2016-08-30 21:26:01","2016-08-30 21:26:01"
3991,5000,1324,1324,6324,2,"2016-08-30 21:26:01","2016-08-30 21:26:01"
3992,8000,1571,0,8000,2,"2016-08-30 21:26:01","2016-08-30 21:26:01"
3993,4000,1359,1359,5359,1,"2016-08-30 21:26:01","2016-08-30 21:26:01"
3994,8500,1590,0,8500,2,"2016-08-30 21:26:01","2016-08-30 21:26:01"
3995,9900,1542,0,9900,2,"2016-08-30 21:26:01","2016-08-30 21:26:01"
3996,8000,1541,1541,9541,1,"2016-08-30 21:26:01","2016-08-30 21:26:01"
3997,8000,1540,1540,9540,2,"2016-08-30 21:26:01","2016-08-30 21:26:01"
3998,5000,1380,1380,6380,1,"2016-08-30 21:26:01","2016-08-30 21:26:01"
3999,9000,1568,1568,10568,1,"2016-08-30 21:26:01","2016-08-30 21:26:01"
4000,9900,1616,1616,11516,1,"2016-08-30 21:26:01","2016-08-30 21:26:01"
4001,8500,1540,1540,10040,2,"2016-08-30 21:26:01","2016-08-30 21:26:01"
4002,9900,1624,1624,11524,1,"2016-08-30 21:26:01","2016-08-30 21:26:01"
4003,9500,1607,1607,11107,1,"2016-08-30 21:26:01","2016-08-30 21:26:01"
4004,9900,1636,1636,11536,2,"2016-08-30 21:26:01","2016-08-30 21:26:01"
4005,9500,1477,1477,10977,1,"2016-08-30 21:26:01","2016-08-30 21:26:01"
4006,8900,1560,0,8900,2,"2016-08-30 21:26:01","2016-08-30 21:26:01"
4007,8000,1433,0,8000,2,"2016-08-30 21:26:01","2016-08-30 21:26:01"
4008,8000,1552,0,8000,2,"2016-08-30 21:26:01","2016-08-30 21:26:01"
4009,9500,1650,0,9500,2,"2016-08-30 21:26:01","2016-08-30 21:26:01"
4010,8000,1411,0,8000,2,"2016-08-30 21:26:01","2016-08-30 21:26:01"
4011,5000,1379,1379,6379,1,"2016-08-30 21:26:01","2016-08-30 21:26:01"
4012,8000,1507,0,8000,2,"2016-08-30 21:26:01","2016-08-30 21:26:01"
4013,8000,1410,0,8000,2,"2016-08-30 21:26:01","2016-08-30 21:26:01"
4014,9500,1641,1641,11141,1,"2016-08-30 21:26:01","2016-08-30 21:26:01"
4015,8000,1540,1540,9540,1,"2016-08-30 21:26:01","2016-08-30 21:26:01"
4016,9500,1532,1532,11032,2,"2016-08-30 21:26:01","2016-08-30 21:26:01"
4017,9900,1503,1503,11403,1,"2016-08-30 21:26:01","2016-08-30 21:26:01"
4018,9900,1543,0,9900,2,"2016-08-30 21:26:01","2016-08-30 21:26:01"
4019,7000,1537,1537,8537,1,"2016-08-30 21:26:01","2016-08-30 21:26:01"
4020,9500,1604,0,9500,2,"2016-08-30 21:26:01","2016-08-30 21:26:01"
4021,8000,1415,0,8000,2,"2016-08-30 21:26:01","2016-08-30 21:26:01"
4022,4000,1238,1238,5238,2,"2016-08-30 21:26:01","2016-08-30 21:26:01"
4023,8500,1564,1564,10064,2,"2016-08-30 21:26:01","2016-08-30 21:26:01"
4024,8000,1429,1429,9429,1,"2016-08-30 21:26:01","2016-08-30 21:26:01"
4025,4000,1206,1206,5206,1,"2016-08-30 21:26:01","2016-08-30 21:26:01"
4026,5000,1428,1428,6428,1,"2016-08-30 21:26:01","2016-08-30 21:26:01"
4027,5000,1406,1406,6406,1,"2016-08-30 21:26:01","2016-08-30 21:26:01"
4028,7000,1549,1549,8549,1,"2016-08-30 21:26:01","2016-08-30 21:26:01"
4029,7000,1458,1458,8458,1,"2016-08-30 21:26:01","2016-08-30 21:26:01"
4030,8900,1632,0,8900,2,"2016-08-30 21:26:01","2016-08-30 21:26:01"
4031,7000,1539,1539,8539,1,"2016-08-30 21:26:01","2016-08-30 21:26:01"
4032,8500,1570,1570,10070,1,"2016-08-30 21:26:01","2016-08-30 21:26:01"
4033,6000,1363,1363,7363,2,"2016-08-30 21:26:01","2016-08-30 21:26:01"
4034,8000,1517,1517,9517,1,"2016-08-30 21:26:01","2016-08-30 21:26:01"
4035,8500,1466,1466,9966,2,"2016-08-30 21:26:01","2016-08-30 21:26:01"
4036,5000,1325,1325,6325,1,"2016-08-30 21:26:01","2016-08-30 21:26:01"
4037,8900,1548,0,8900,2,"2016-08-30 21:26:01","2016-08-30 21:26:01"
4038,8000,1452,0,8000,2,"2016-08-30 21:26:01","2016-08-30 21:26:01"
4039,8900,1520,0,8900,2,"2016-08-30 21:26:01","2016-08-30 21:26:01"
4040,8000,1590,1590,9590,2,"2016-08-30 21:26:01","2016-08-30 21:26:01"
4041,6000,1313,1313,7313,1,"2016-08-30 21:26:01","2016-08-30 21:26:01"
4042,4000,1322,1322,5322,1,"2016-08-30 21:26:01","2016-08-30 21:26:01"
4043,4000,1215,1215,5215,1,"2016-08-30 21:26:01","2016-08-30 21:26:01"
4044,9900,1668,1668,11568,1,"2016-08-30 21:26:01","2016-08-30 21:26:01"
4045,8000,1589,0,8000,2,"2016-08-30 21:26:01","2016-08-30 21:26:01"
4046,4000,1210,1210,5210,2,"2016-08-30 21:26:01","2016-08-30 21:26:01"
4047,4000,1286,1286,5286,1,"2016-08-30 21:26:01","2016-08-30 21:26:01"
4048,8900,1616,0,8900,2,"2016-08-30 21:26:01","2016-08-30 21:26:01"
4049,8900,1564,0,8900,2,"2016-08-30 21:26:01","2016-08-30 21:26:01"
4050,8000,1515,1515,9515,1,"2016-08-30 21:26:01","2016-08-30 21:26:01"
4051,8000,1456,0,8000,2,"2016-08-30 21:26:01","2016-08-30 21:26:01"
4052,8500,1543,1543,10043,1,"2016-08-30 21:26:01","2016-08-30 21:26:01"
4053,8000,1597,1597,9597,2,"2016-08-30 21:26:01","2016-08-30 21:26:01"
4054,8000,1401,1401,9401,1,"2016-08-30 21:26:01","2016-08-30 21:26:01"
4055,8500,1502,0,8500,2,"2016-08-30 21:26:01","2016-08-30 21:26:01"
4056,8000,1539,0,8000,2,"2016-08-30 21:26:01","2016-08-30 21:26:01"
4057,8900,1485,1485,10385,2,"2016-08-30 21:26:01","2016-08-30 21:26:01"
4058,8900,1604,1604,10504,1,"2016-08-30 21:26:01","2016-08-30 21:26:01"
4059,4000,1266,1266,5266,1,"2016-08-30 21:26:01","2016-08-30 21:26:01"
4060,4000,1307,1307,5307,1,"2016-08-30 21:26:01","2016-08-30 21:26:01"
4061,8900,1468,0,8900,2,"2016-08-30 21:26:01","2016-08-30 21:26:01"
4062,8000,1433,0,8000,2,"2016-08-30 21:26:01","2016-08-30 21:26:01"
4063,8000,1525,0,8000,2,"2016-08-30 21:26:01","2016-08-30 21:26:01"
4064,8000,1513,1513,9513,2,"2016-08-30 21:26:01","2016-08-30 21:26:01"
4065,8000,1464,0,8000,2,"2016-08-30 21:26:01","2016-08-30 21:26:01"
4066,8500,1616,0,8500,2,"2016-08-30 21:26:01","2016-08-30 21:26:01"
4067,8000,1404,0,8000,2,"2016-08-30 21:26:01","2016-08-30 21:26:01"
4068,9900,1534,1534,11434,1,"2016-08-30 21:26:01","2016-08-30 21:26:01"
4069,5000,1415,1415,6415,1,"2016-08-30 21:26:01","2016-08-30 21:26:01"
4070,5000,1448,1448,6448,2,"2016-08-30 21:26:01","2016-08-30 21:26:01"
4071,5000,1290,1290,6290,1,"2016-08-30 21:26:01","2016-08-30 21:26:01"
4072,9000,1574,1574,10574,1,"2016-08-30 21:26:01","2016-08-30 21:26:01"
4073,8000,1593,1593,9593,2,"2016-08-30 21:26:01","2016-08-30 21:26:01"
4074,4000,1302,1302,5302,1,"2016-08-30 21:26:01","2016-08-30 21:26:01"
4075,4000,1254,1254,5254,2,"2016-08-30 21:26:01","2016-08-30 21:26:01"
4076,8500,1495,0,8500,2,"2016-08-30 21:26:01","2016-08-30 21:26:01"
4077,8900,1593,0,8900,2,"2016-08-30 21:26:01","2016-08-30 21:26:01"
4078,4000,1344,1344,5344,1,"2016-08-30 21:26:01","2016-08-30 21:26:01"
4079,9500,1504,1504,11004,1,"2016-08-30 21:26:01","2016-08-30 21:26:01"
4080,8500,1588,0,8500,2,"2016-08-30 21:26:01","2016-08-30 21:26:01"
4081,8500,1547,0,8500,2,"2016-08-30 21:26:01","2016-08-30 21:26:01"
4082,8900,1486,0,8900,2,"2016-08-30 21:26:01","2016-08-30 21:26:01"
4083,8900,1571,0,8900,2,"2016-08-30 21:26:01","2016-08-30 21:26:01"
4084,6000,1436,1436,7436,1,"2016-08-30 21:26:01","2016-08-30 21:26:01"
4085,8500,1540,0,8500,2,"2016-08-30 21:26:01","2016-08-30 21:26:01"
4086,9900,1653,1653,11553,1,"2016-08-30 21:26:01","2016-08-30 21:26:01"
4087,5000,1387,1387,6387,2,"2016-08-30 21:26:01","2016-08-30 21:26:01"
4088,8900,1535,0,8900,2,"2016-08-30 21:26:01","2016-08-30 21:26:01"
4089,9000,1489,1489,10489,1,"2016-08-30 21:26:01","2016-08-30 21:26:01"
4090,8900,1515,1515,10415,1,"2016-08-30 21:26:01","2016-08-30 21:26:01"
4091,7000,1446,1446,8446,1,"2016-08-30 21:26:01","2016-08-30 21:26:01"
4092,8500,1478,0,8500,2,"2016-08-30 21:26:01","2016-08-30 21:26:01"
4093,9900,1503,1503,11403,1,"2016-08-30 21:26:01","2016-08-30 21:26:01"
4094,8000,1594,1594,9594,2,"2016-08-30 21:26:01","2016-08-30 21:26:01"
4095,4000,1386,1386,5386,1,"2016-08-30 21:26:01","2016-08-30 21:26:01"
4096,9900,1536,1536,11436,1,"2016-08-30 21:26:01","2016-08-30 21:26:01"
4097,5000,1345,1345,6345,1,"2016-08-30 21:26:01","2016-08-30 21:26:01"
4098,5000,1389,1389,6389,1,"2016-08-30 21:26:01","2016-08-30 21:26:01"
4099,7000,1436,1436,8436,1,"2016-08-30 21:26:01","2016-08-30 21:26:01"
4100,9500,1634,0,9500,2,"2016-08-30 21:26:01","2016-08-30 21:26:01"
4101,5000,1333,1333,6333,1,"2016-08-30 21:26:01","2016-08-30 21:26:01"
4102,8900,1447,1447,10347,2,"2016-08-30 21:26:01","2016-08-30 21:26:01"
4103,9000,1636,0,9000,2,"2016-08-30 21:26:01","2016-08-30 21:26:01"
4104,4000,1256,1256,5256,1,"2016-08-30 21:26:01","2016-08-30 21:26:01"
4105,8000,1578,0,8000,2,"2016-08-30 21:26:01","2016-08-30 21:26:01"
4106,8000,1419,1419,9419,1,"2016-08-30 21:26:01","2016-08-30 21:26:01"
4107,7000,1395,1395,8395,1,"2016-08-30 21:26:01","2016-08-30 21:26:01"
4108,5000,1407,1407,6407,1,"2016-08-30 21:26:01","2016-08-30 21:26:01"
4109,8000,1596,0,8000,2,"2016-08-30 21:26:01","2016-08-30 21:26:01"
4110,9500,1579,1579,11079,1,"2016-08-30 21:26:01","2016-08-30 21:26:01"
4111,4000,1386,1386,5386,1,"2016-08-30 21:26:01","2016-08-30 21:26:01"
4112,4000,1387,1387,5387,1,"2016-08-30 21:26:01","2016-08-30 21:26:01"
4113,8500,1570,0,8500,2,"2016-08-30 21:26:01","2016-08-30 21:26:01"
4114,8500,1582,0,8500,2,"2016-08-30 21:26:01","2016-08-30 21:26:01"
4115,8000,1492,0,8000,2,"2016-08-30 21:26:01","2016-08-30 21:26:01"
4116,5000,1337,1337,6337,2,"2016-08-30 21:26:01","2016-08-30 21:26:01"
4117,8000,1559,1559,9559,1,"2016-08-30 21:26:01","2016-08-30 21:26:01"
4118,8000,1476,0,8000,2,"2016-08-30 21:26:01","2016-08-30 21:26:01"
4119,8000,1536,1536,9536,2,"2016-08-30 21:26:01","2016-08-30 21:26:01"
4120,9900,1602,1602,11502,1,"2016-08-30 21:26:01","2016-08-30 21:26:01"
4121,5000,1286,1286,6286,1,"2016-08-30 21:26:01","2016-08-30 21:26:01"
4122,9900,1550,1550,11450,1,"2016-08-30 21:26:01","2016-08-30 21:26:01"
4123,9500,1521,0,9500,2,"2016-08-30 21:26:01","2016-08-30 21:26:01"
4124,8000,1561,1561,9561,1,"2016-08-30 21:26:01","2016-08-30 21:26:01"
4125,8000,1575,0,8000,2,"2016-08-30 21:26:01","2016-08-30 21:26:01"
4126,8000,1440,1440,9440,2,"2016-08-30 21:26:01","2016-08-30 21:26:01"
4127,8900,1472,1472,10372,2,"2016-08-30 21:26:01","2016-08-30 21:26:01"
4128,8900,1505,0,8900,2,"2016-08-30 21:26:01","2016-08-30 21:26:01"
4129,8000,1583,1583,9583,2,"2016-08-30 21:26:01","2016-08-30 21:26:01"
4130,8000,1418,0,8000,2,"2016-08-30 21:26:01","2016-08-30 21:26:01"
4131,8500,1440,0,8500,2,"2016-08-30 21:26:01","2016-08-30 21:26:01"
4132,8500,1489,0,8500,2,"2016-08-30 21:26:01","2016-08-30 21:26:01"
4133,8000,1419,0,8000,2,"2016-08-30 21:26:01","2016-08-30 21:26:01"
4134,8000,1581,0,8000,2,"2016-08-30 21:26:01","2016-08-30 21:26:01"
4135,8900,1570,0,8900,2,"2016-08-30 21:26:01","2016-08-30 21:26:01"
4136,5000,1291,1291,6291,2,"2016-08-30 21:26:01","2016-08-30 21:26:01"
4137,8000,1464,0,8000,2,"2016-08-30 21:26:01","2016-08-30 21:26:01"
4138,9900,1537,1537,11437,1,"2016-08-30 21:26:01","2016-08-30 21:26:01"
4139,6000,1452,1452,7452,1,"2016-08-30 21:26:01","2016-08-30 21:26:01"
4140,8000,1470,0,8000,2,"2016-08-30 21:26:01","2016-08-30 21:26:01"
4141,8000,1528,0,8000,2,"2016-08-30 21:26:01","2016-08-30 21:26:01"
4142,8000,1453,1453,9453,2,"2016-08-30 21:26:01","2016-08-30 21:26:01"
4143,4000,1376,1376,5376,1,"2016-08-30 21:26:01","2016-08-30 21:26:01"
4144,5000,1429,1429,6429,1,"2016-08-30 21:26:01","2016-08-30 21:26:01"
4145,8000,1433,1433,9433,1,"2016-08-30 21:26:01","2016-08-30 21:26:01"
4146,8000,1582,1582,9582,1,"2016-08-30 21:26:01","2016-08-30 21:26:01"
4147,8000,1558,1558,9558,1,"2016-08-30 21:26:01","2016-08-30 21:26:01"
4148,9500,1636,1636,11136,1,"2016-08-30 21:26:01","2016-08-30 21:26:01"
4149,9900,1675,1675,11575,1,"2016-08-30 21:26:01","2016-08-30 21:26:01"
4150,5000,1308,1308,6308,1,"2016-08-30 21:26:01","2016-08-30 21:26:01"
4151,9500,1626,0,9500,2,"2016-08-30 21:26:01","2016-08-30 21:26:01"
4152,8900,1584,0,8900,2,"2016-08-30 21:26:01","2016-08-30 21:26:01"
4153,5000,1387,1387,6387,1,"2016-08-30 21:26:01","2016-08-30 21:26:01"
4154,9000,1632,1632,10632,1,"2016-08-30 21:26:01","2016-08-30 21:26:01"
4155,4000,1336,1336,5336,1,"2016-08-30 21:26:01","2016-08-30 21:26:01"
4156,9900,1501,1501,11401,1,"2016-08-30 21:26:01","2016-08-30 21:26:01"
4157,8000,1573,0,8000,2,"2016-08-30 21:26:01","2016-08-30 21:26:01"
4158,8900,1578,0,8900,2,"2016-08-30 21:26:01","2016-08-30 21:26:01"
4159,9900,1605,1605,11505,1,"2016-08-30 21:26:01","2016-08-30 21:26:01"
4160,7000,1440,1440,8440,1,"2016-08-30 21:26:01","2016-08-30 21:26:01"
4161,8500,1543,0,8500,2,"2016-08-30 21:26:01","2016-08-30 21:26:01"
4162,8500,1475,1475,9975,2,"2016-08-30 21:26:01","2016-08-30 21:26:01"
4163,8000,1553,1553,9553,1,"2016-08-30 21:26:01","2016-08-30 21:26:01"
4164,4000,1382,1382,5382,1,"2016-08-30 21:26:01","2016-08-30 21:26:01"
4165,8500,1551,0,8500,2,"2016-08-30 21:26:01","2016-08-30 21:26:01"
4166,5000,1268,1268,6268,2,"2016-08-30 21:26:01","2016-08-30 21:26:01"
4167,8900,1465,0,8900,2,"2016-08-30 21:26:01","2016-08-30 21:26:01"
4168,9500,1650,1650,11150,1,"2016-08-30 21:26:01","2016-08-30 21:26:01"
4169,5000,1327,1327,6327,1,"2016-08-30 21:26:01","2016-08-30 21:26:01"
4170,8000,1443,0,8000,2,"2016-08-30 21:26:01","2016-08-30 21:26:01"
4171,8900,1563,1563,10463,2,"2016-08-30 21:26:01","2016-08-30 21:26:01"
4172,9500,1632,1632,11132,1,"2016-08-30 21:26:01","2016-08-30 21:26:01"
4173,8900,1623,1623,10523,1,"2016-08-30 21:26:01","2016-08-30 21:26:01"
4174,4000,1357,1357,5357,2,"2016-08-30 21:26:01","2016-08-30 21:26:01"
4175,8500,1526,1526,10026,2,"2016-08-30 21:26:01","2016-08-30 21:26:01"
4176,8000,1447,0,8000,2,"2016-08-30 21:26:01","2016-08-30 21:26:01"
4177,8900,1592,0,8900,2,"2016-08-30 21:26:01","2016-08-30 21:26:01"
4178,8000,1418,1418,9418,1,"2016-08-30 21:26:01","2016-08-30 21:26:01"
4179,4000,1279,1279,5279,1,"2016-08-30 21:26:01","2016-08-30 21:26:01"
4180,9900,1694,1694,11594,1,"2016-08-30 21:26:01","2016-08-30 21:26:01"
4181,4000,1389,1389,5389,1,"2016-08-30 21:26:01","2016-08-30 21:26:01"
4182,8500,1485,0,8500,2,"2016-08-30 21:26:01","2016-08-30 21:26:01"
4183,8000,1477,1477,9477,1,"2016-08-30 21:26:01","2016-08-30 21:26:01"
4184,4000,1262,1262,5262,1,"2016-08-30 21:26:01","2016-08-30 21:26:01"
4185,8000,1464,1464,9464,2,"2016-08-30 21:26:01","2016-08-30 21:26:01"
4186,8900,1520,1520,10420,1,"2016-08-30 21:26:01","2016-08-30 21:26:01"
4187,4000,1310,1310,5310,1,"2016-08-30 21:26:01","2016-08-30 21:26:01"
4188,8000,1471,0,8000,2,"2016-08-30 21:26:01","2016-08-30 21:26:01"
4189,9900,1532,1532,11432,1,"2016-08-30 21:26:01","2016-08-30 21:26:01"
4190,6000,1406,1406,7406,1,"2016-08-30 21:26:01","2016-08-30 21:26:01"
4191,5000,1275,1275,6275,1,"2016-08-30 21:26:01","2016-08-30 21:26:01"
4192,8000,1484,0,8000,2,"2016-08-30 21:26:01","2016-08-30 21:26:01"
4193,8000,1555,1555,9555,1,"2016-08-30 21:26:01","2016-08-30 21:26:01"
4194,9000,1513,1513,10513,1,"2016-08-30 21:26:01","2016-08-30 21:26:01"
4195,8500,1562,0,8500,2,"2016-08-30 21:26:01","2016-08-30 21:26:01"
4196,8000,1435,0,8000,2,"2016-08-30 21:26:01","2016-08-30 21:26:01"
4197,9900,1682,1682,11582,1,"2016-08-30 21:26:01","2016-08-30 21:26:01"
4198,4000,1294,1294,5294,1,"2016-08-30 21:26:01","2016-08-30 21:26:01"
4199,9500,1480,0,9500,2,"2016-08-30 21:26:02","2016-08-30 21:26:02"
4200,9900,1517,1517,11417,1,"2016-08-30 21:26:02","2016-08-30 21:26:02"
4201,8500,1600,0,8500,2,"2016-08-30 21:26:02","2016-08-30 21:26:02"
4202,8500,1452,1452,9952,2,"2016-08-30 21:26:02","2016-08-30 21:26:02"
4203,8900,1526,0,8900,2,"2016-08-30 21:26:02","2016-08-30 21:26:02"
4204,8900,1535,1535,10435,1,"2016-08-30 21:26:02","2016-08-30 21:26:02"
4205,8000,1485,0,8000,2,"2016-08-30 21:26:02","2016-08-30 21:26:02"
4206,8500,1530,0,8500,2,"2016-08-30 21:26:02","2016-08-30 21:26:02"
4207,4000,1255,1255,5255,1,"2016-08-30 21:26:02","2016-08-30 21:26:02"
4208,8000,1403,1403,9403,1,"2016-08-30 21:26:02","2016-08-30 21:26:02"
4209,8000,1433,0,8000,2,"2016-08-30 21:26:02","2016-08-30 21:26:02"
4210,9500,1606,1606,11106,1,"2016-08-30 21:26:02","2016-08-30 21:26:02"
4211,7000,1498,1498,8498,1,"2016-08-30 21:26:02","2016-08-30 21:26:02"
4212,8000,1411,1411,9411,1,"2016-08-30 21:26:02","2016-08-30 21:26:02"
4213,8900,1530,1530,10430,2,"2016-08-30 21:26:02","2016-08-30 21:26:02"
4214,8000,1447,0,8000,2,"2016-08-30 21:26:02","2016-08-30 21:26:02"
4215,9000,1643,1643,10643,1,"2016-08-30 21:26:02","2016-08-30 21:26:02"
4216,7000,1369,1369,8369,1,"2016-08-30 21:26:02","2016-08-30 21:26:02"
4217,8900,1599,1599,10499,2,"2016-08-30 21:26:02","2016-08-30 21:26:02"
4218,8500,1505,1505,10005,2,"2016-08-30 21:26:02","2016-08-30 21:26:02"
4219,4000,1232,1232,5232,1,"2016-08-30 21:26:02","2016-08-30 21:26:02"
4220,8500,1495,1495,9995,2,"2016-08-30 21:26:02","2016-08-30 21:26:02"
4221,8900,1557,0,8900,2,"2016-08-30 21:26:02","2016-08-30 21:26:02"
4222,8000,1575,1575,9575,1,"2016-08-30 21:26:02","2016-08-30 21:26:02"
4223,4000,1327,1327,5327,2,"2016-08-30 21:26:02","2016-08-30 21:26:02"
4224,8000,1484,0,8000,2,"2016-08-30 21:26:02","2016-08-30 21:26:02"
4225,8000,1460,1460,9460,1,"2016-08-30 21:26:02","2016-08-30 21:26:02"
4226,8000,1561,0,8000,2,"2016-08-30 21:26:02","2016-08-30 21:26:02"
4227,5000,1282,1282,6282,1,"2016-08-30 21:26:02","2016-08-30 21:26:02"
4228,8500,1618,1618,10118,1,"2016-08-30 21:26:02","2016-08-30 21:26:02"
4229,8000,1576,0,8000,2,"2016-08-30 21:26:02","2016-08-30 21:26:02"
4230,8000,1544,1544,9544,1,"2016-08-30 21:26:02","2016-08-30 21:26:02"
4231,4000,1294,1294,5294,1,"2016-08-30 21:26:02","2016-08-30 21:26:02"
4232,8000,1487,1487,9487,2,"2016-08-30 21:26:02","2016-08-30 21:26:02"
4233,7000,1409,1409,8409,1,"2016-08-30 21:26:02","2016-08-30 21:26:02"
4234,8000,1438,1438,9438,1,"2016-08-30 21:26:02","2016-08-30 21:26:02"
4235,8500,1485,1485,9985,1,"2016-08-30 21:26:02","2016-08-30 21:26:02"
4236,8500,1468,1468,9968,1,"2016-08-30 21:26:02","2016-08-30 21:26:02"
4237,5000,1340,1340,6340,2,"2016-08-30 21:26:02","2016-08-30 21:26:02"
4238,8900,1533,0,8900,2,"2016-08-30 21:26:02","2016-08-30 21:26:02"
4239,8500,1610,1610,10110,1,"2016-08-30 21:26:02","2016-08-30 21:26:02"
4240,8900,1558,1558,10458,1,"2016-08-30 21:26:02","2016-08-30 21:26:02"
4241,9900,1512,1512,11412,1,"2016-08-30 21:26:02","2016-08-30 21:26:02"
4242,8500,1429,0,8500,2,"2016-08-30 21:26:02","2016-08-30 21:26:02"
4243,9900,1634,0,9900,2,"2016-08-30 21:26:02","2016-08-30 21:26:02"
4244,4000,1361,1361,5361,1,"2016-08-30 21:26:02","2016-08-30 21:26:02"
4245,8900,1453,1453,10353,1,"2016-08-30 21:26:02","2016-08-30 21:26:02"
4246,4000,1213,1213,5213,2,"2016-08-30 21:26:02","2016-08-30 21:26:02"
4247,8900,1472,0,8900,2,"2016-08-30 21:26:02","2016-08-30 21:26:02"
4248,8000,1591,1591,9591,2,"2016-08-30 21:26:02","2016-08-30 21:26:02"
4249,5000,1322,1322,6322,1,"2016-08-30 21:26:02","2016-08-30 21:26:02"
4250,6000,1381,1381,7381,2,"2016-08-30 21:26:02","2016-08-30 21:26:02"
4251,8900,1628,1628,10528,1,"2016-08-30 21:26:02","2016-08-30 21:26:02"
4252,5000,1431,1431,6431,2,"2016-08-30 21:26:02","2016-08-30 21:26:02"
4253,9900,1616,0,9900,2,"2016-08-30 21:26:02","2016-08-30 21:26:02"
4254,7000,1358,1358,8358,1,"2016-08-30 21:26:02","2016-08-30 21:26:02"
4255,4000,1224,1224,5224,1,"2016-08-30 21:26:02","2016-08-30 21:26:02"
4256,8000,1476,0,8000,2,"2016-08-30 21:26:02","2016-08-30 21:26:02"
4257,5000,1378,1378,6378,1,"2016-08-30 21:26:02","2016-08-30 21:26:02"
4258,8000,1571,0,8000,2,"2016-08-30 21:26:02","2016-08-30 21:26:02"
4259,8000,1431,0,8000,2,"2016-08-30 21:26:02","2016-08-30 21:26:02"
4260,9900,1528,1528,11428,1,"2016-08-30 21:26:02","2016-08-30 21:26:02"
4261,9000,1510,1510,10510,1,"2016-08-30 21:26:02","2016-08-30 21:26:02"
4262,7000,1430,1430,8430,2,"2016-08-30 21:26:02","2016-08-30 21:26:02"
4263,7000,1405,1405,8405,1,"2016-08-30 21:26:02","2016-08-30 21:26:02"
4264,8500,1434,1434,9934,1,"2016-08-30 21:26:02","2016-08-30 21:26:02"
4265,8000,1568,0,8000,2,"2016-08-30 21:26:02","2016-08-30 21:26:02"
4266,8500,1480,0,8500,2,"2016-08-30 21:26:02","2016-08-30 21:26:02"
4267,8900,1553,0,8900,2,"2016-08-30 21:26:02","2016-08-30 21:26:02"
4268,8000,1476,0,8000,2,"2016-08-30 21:26:02","2016-08-30 21:26:02"
4269,5000,1264,1264,6264,1,"2016-08-30 21:26:02","2016-08-30 21:26:02"
4270,8000,1470,0,8000,2,"2016-08-30 21:26:02","2016-08-30 21:26:02"
4271,8900,1529,1529,10429,2,"2016-08-30 21:26:02","2016-08-30 21:26:02"
4272,4000,1385,1385,5385,2,"2016-08-30 21:26:02","2016-08-30 21:26:02"
4273,8500,1571,1571,10071,1,"2016-08-30 21:26:02","2016-08-30 21:26:02"
4274,8000,1433,0,8000,2,"2016-08-30 21:26:02","2016-08-30 21:26:02"
4275,9000,1530,1530,10530,1,"2016-08-30 21:26:02","2016-08-30 21:26:02"
4276,4000,1347,1347,5347,1,"2016-08-30 21:26:02","2016-08-30 21:26:02"
4277,8500,1465,0,8500,2,"2016-08-30 21:26:02","2016-08-30 21:26:02"
4278,8900,1543,1543,10443,2,"2016-08-30 21:26:02","2016-08-30 21:26:02"
4279,9900,1625,1625,11525,1,"2016-08-30 21:26:02","2016-08-30 21:26:02"
4280,8900,1463,1463,10363,2,"2016-08-30 21:26:02","2016-08-30 21:26:02"
4281,9900,1647,1647,11547,1,"2016-08-30 21:26:02","2016-08-30 21:26:02"
4282,9900,1668,1668,11568,1,"2016-08-30 21:26:02","2016-08-30 21:26:02"
4283,8000,1471,0,8000,2,"2016-08-30 21:26:02","2016-08-30 21:26:02"
4284,8000,1462,1462,9462,2,"2016-08-30 21:26:02","2016-08-30 21:26:02"
4285,7000,1435,1435,8435,2,"2016-08-30 21:26:02","2016-08-30 21:26:02"
4286,4000,1286,1286,5286,2,"2016-08-30 21:26:02","2016-08-30 21:26:02"
4287,8500,1551,0,8500,2,"2016-08-30 21:26:02","2016-08-30 21:26:02"
4288,7000,1508,1508,8508,1,"2016-08-30 21:26:02","2016-08-30 21:26:02"
4289,9000,1496,1496,10496,1,"2016-08-30 21:26:02","2016-08-30 21:26:02"
4290,8500,1499,1499,9999,2,"2016-08-30 21:26:02","2016-08-30 21:26:02"
4291,8000,1412,1412,9412,1,"2016-08-30 21:26:02","2016-08-30 21:26:02"
4292,8500,1459,0,8500,2,"2016-08-30 21:26:02","2016-08-30 21:26:02"
4293,4000,1317,1317,5317,1,"2016-08-30 21:26:02","2016-08-30 21:26:02"
4294,8000,1471,1471,9471,1,"2016-08-30 21:26:02","2016-08-30 21:26:02"
4295,8900,1515,1515,10415,2,"2016-08-30 21:26:02","2016-08-30 21:26:02"
4296,9900,1687,1687,11587,1,"2016-08-30 21:26:02","2016-08-30 21:26:02"
4297,6000,1323,1323,7323,2,"2016-08-30 21:26:02","2016-08-30 21:26:02"
4298,9900,1672,1672,11572,2,"2016-08-30 21:26:02","2016-08-30 21:26:02"
4299,5000,1383,1383,6383,1,"2016-08-30 21:26:02","2016-08-30 21:26:02"
4300,8000,1499,0,8000,2,"2016-08-30 21:26:02","2016-08-30 21:26:02"
4301,5000,1272,1272,6272,1,"2016-08-30 21:26:02","2016-08-30 21:26:02"
4302,8000,1415,0,8000,2,"2016-08-30 21:26:02","2016-08-30 21:26:02"
4303,8500,1516,0,8500,2,"2016-08-30 21:26:02","2016-08-30 21:26:02"
4304,8000,1504,1504,9504,1,"2016-08-30 21:26:02","2016-08-30 21:26:02"
4305,5000,1413,1413,6413,2,"2016-08-30 21:26:02","2016-08-30 21:26:02"
4306,8500,1586,0,8500,2,"2016-08-30 21:26:02","2016-08-30 21:26:02"
4307,4000,1346,1346,5346,1,"2016-08-30 21:26:02","2016-08-30 21:26:02"
4308,8500,1521,0,8500,2,"2016-08-30 21:26:02","2016-08-30 21:26:02"
4309,8500,1615,0,8500,2,"2016-08-30 21:26:02","2016-08-30 21:26:02"
4310,8900,1639,1639,10539,1,"2016-08-30 21:26:02","2016-08-30 21:26:02"
4311,8000,1548,1548,9548,1,"2016-08-30 21:26:02","2016-08-30 21:26:02"
4312,5000,1254,1254,6254,1,"2016-08-30 21:26:02","2016-08-30 21:26:02"
4313,8000,1488,0,8000,2,"2016-08-30 21:26:02","2016-08-30 21:26:02"
4314,5000,1343,1343,6343,1,"2016-08-30 21:26:02","2016-08-30 21:26:02"
4315,8900,1615,1615,10515,1,"2016-08-30 21:26:02","2016-08-30 21:26:02"
4316,5000,1343,1343,6343,2,"2016-08-30 21:26:02","2016-08-30 21:26:02"
4317,8900,1589,1589,10489,2,"2016-08-30 21:26:02","2016-08-30 21:26:02"
4318,8900,1471,0,8900,2,"2016-08-30 21:26:02","2016-08-30 21:26:02"
4319,8000,1419,1419,9419,1,"2016-08-30 21:26:02","2016-08-30 21:26:02"
4320,8000,1558,0,8000,2,"2016-08-30 21:26:02","2016-08-30 21:26:02"
4321,8000,1584,0,8000,2,"2016-08-30 21:26:02","2016-08-30 21:26:02"
4322,8000,1508,0,8000,2,"2016-08-30 21:26:02","2016-08-30 21:26:02"
4323,8000,1488,0,8000,2,"2016-08-30 21:26:02","2016-08-30 21:26:02"
4324,7000,1414,1414,8414,2,"2016-08-30 21:26:02","2016-08-30 21:26:02"
4325,8500,1498,1498,9998,1,"2016-08-30 21:26:02","2016-08-30 21:26:02"
4326,9500,1674,1674,11174,1,"2016-08-30 21:26:02","2016-08-30 21:26:02"
4327,6000,1462,1462,7462,1,"2016-08-30 21:26:02","2016-08-30 21:26:02"
4328,4000,1351,1351,5351,1,"2016-08-30 21:26:02","2016-08-30 21:26:02"
4329,9000,1562,1562,10562,1,"2016-08-30 21:26:02","2016-08-30 21:26:02"
4330,8500,1609,1609,10109,2,"2016-08-30 21:26:02","2016-08-30 21:26:02"
4331,8500,1601,1601,10101,1,"2016-08-30 21:26:02","2016-08-30 21:26:02"
4332,8000,1548,0,8000,2,"2016-08-30 21:26:02","2016-08-30 21:26:02"
4333,5000,1369,1369,6369,1,"2016-08-30 21:26:02","2016-08-30 21:26:02"
4334,8000,1414,1414,9414,1,"2016-08-30 21:26:02","2016-08-30 21:26:02"
4335,9900,1656,0,9900,2,"2016-08-30 21:26:02","2016-08-30 21:26:02"
4336,8900,1474,0,8900,2,"2016-08-30 21:26:02","2016-08-30 21:26:02"
4337,5000,1301,1301,6301,1,"2016-08-30 21:26:02","2016-08-30 21:26:02"
4338,7000,1538,1538,8538,1,"2016-08-30 21:26:02","2016-08-30 21:26:02"
4339,8500,1566,0,8500,2,"2016-08-30 21:26:02","2016-08-30 21:26:02"
4340,9500,1524,1524,11024,1,"2016-08-30 21:26:02","2016-08-30 21:26:02"
4341,8500,1498,1498,9998,2,"2016-08-30 21:26:02","2016-08-30 21:26:02"
4342,4000,1306,1306,5306,2,"2016-08-30 21:26:02","2016-08-30 21:26:02"
4343,8000,1550,1550,9550,1,"2016-08-30 21:26:02","2016-08-30 21:26:02"
4344,9900,1640,0,9900,2,"2016-08-30 21:26:02","2016-08-30 21:26:02"
4345,5000,1425,1425,6425,1,"2016-08-30 21:26:02","2016-08-30 21:26:02"
4346,8500,1435,1435,9935,2,"2016-08-30 21:26:02","2016-08-30 21:26:02"
4347,8000,1475,1475,9475,2,"2016-08-30 21:26:02","2016-08-30 21:26:02"
4348,6000,1488,1488,7488,1,"2016-08-30 21:26:02","2016-08-30 21:26:02"
4349,8000,1465,0,8000,2,"2016-08-30 21:26:02","2016-08-30 21:26:02"
4350,9000,1461,1461,10461,1,"2016-08-30 21:26:02","2016-08-30 21:26:02"
4351,4000,1391,1391,5391,1,"2016-08-30 21:26:02","2016-08-30 21:26:02"
4352,8900,1510,0,8900,2,"2016-08-30 21:26:02","2016-08-30 21:26:02"
4353,8000,1584,1584,9584,1,"2016-08-30 21:26:02","2016-08-30 21:26:02"
4354,8000,1411,0,8000,2,"2016-08-30 21:26:02","2016-08-30 21:26:02"
4355,8000,1512,0,8000,2,"2016-08-30 21:26:02","2016-08-30 21:26:02"
4356,9900,1497,1497,11397,1,"2016-08-30 21:26:02","2016-08-30 21:26:02"
4357,8000,1406,1406,9406,1,"2016-08-30 21:26:02","2016-08-30 21:26:02"
4358,8900,1573,1573,10473,1,"2016-08-30 21:26:02","2016-08-30 21:26:02"
4359,8900,1454,0,8900,2,"2016-08-30 21:26:02","2016-08-30 21:26:02"
4360,7000,1416,1416,8416,1,"2016-08-30 21:26:02","2016-08-30 21:26:02"
4361,4000,1209,1209,5209,1,"2016-08-30 21:26:02","2016-08-30 21:26:02"
4362,8000,1514,1514,9514,1,"2016-08-30 21:26:02","2016-08-30 21:26:02"
4363,8000,1525,0,8000,2,"2016-08-30 21:26:02","2016-08-30 21:26:02"
4364,9900,1602,1602,11502,1,"2016-08-30 21:26:02","2016-08-30 21:26:02"
4365,8000,1479,1479,9479,1,"2016-08-30 21:26:02","2016-08-30 21:26:02"
4366,8500,1473,1473,9973,1,"2016-08-30 21:26:02","2016-08-30 21:26:02"
4367,9900,1655,0,9900,2,"2016-08-30 21:26:02","2016-08-30 21:26:02"
4368,8900,1519,0,8900,2,"2016-08-30 21:26:02","2016-08-30 21:26:02"
4369,9500,1593,1593,11093,2,"2016-08-30 21:26:02","2016-08-30 21:26:02"
4370,8500,1593,0,8500,2,"2016-08-30 21:26:02","2016-08-30 21:26:02"
4371,8500,1522,1522,10022,1,"2016-08-30 21:26:02","2016-08-30 21:26:02"
4372,8000,1525,1525,9525,2,"2016-08-30 21:26:02","2016-08-30 21:26:02"
4373,8500,1537,1537,10037,1,"2016-08-30 21:26:02","2016-08-30 21:26:02"
4374,7000,1430,1430,8430,2,"2016-08-30 21:26:02","2016-08-30 21:26:02"
4375,8500,1554,0,8500,2,"2016-08-30 21:26:02","2016-08-30 21:26:02"
4376,8500,1588,0,8500,2,"2016-08-30 21:26:02","2016-08-30 21:26:02"
4377,8000,1412,1412,9412,2,"2016-08-30 21:26:02","2016-08-30 21:26:02"
4378,8000,1503,0,8000,2,"2016-08-30 21:26:02","2016-08-30 21:26:02"
4379,8000,1425,0,8000,2,"2016-08-30 21:26:02","2016-08-30 21:26:02"
4380,8900,1474,0,8900,2,"2016-08-30 21:26:02","2016-08-30 21:26:02"
4381,8500,1426,1426,9926,1,"2016-08-30 21:26:02","2016-08-30 21:26:02"
4382,4000,1206,1206,5206,1,"2016-08-30 21:26:02","2016-08-30 21:26:02"
4383,8500,1579,1579,10079,1,"2016-08-30 21:26:02","2016-08-30 21:26:02"
4384,8000,1518,0,8000,2,"2016-08-30 21:26:02","2016-08-30 21:26:02"
4385,9500,1611,1611,11111,1,"2016-08-30 21:26:02","2016-08-30 21:26:02"
4386,5000,1257,1257,6257,1,"2016-08-30 21:26:02","2016-08-30 21:26:02"
4387,4000,1379,1379,5379,1,"2016-08-30 21:26:02","2016-08-30 21:26:02"
4388,9500,1600,0,9500,2,"2016-08-30 21:26:02","2016-08-30 21:26:02"
4389,8000,1507,0,8000,2,"2016-08-30 21:26:02","2016-08-30 21:26:02"
4390,8000,1451,1451,9451,1,"2016-08-30 21:26:02","2016-08-30 21:26:02"
4391,8500,1591,0,8500,2,"2016-08-30 21:26:02","2016-08-30 21:26:02"
4392,8000,1402,1402,9402,1,"2016-08-30 21:26:02","2016-08-30 21:26:02"
4393,9900,1645,1645,11545,1,"2016-08-30 21:26:02","2016-08-30 21:26:02"
4394,8000,1408,1408,9408,1,"2016-08-30 21:26:02","2016-08-30 21:26:02"
4395,9900,1628,1628,11528,1,"2016-08-30 21:26:02","2016-08-30 21:26:02"
4396,8900,1537,0,8900,2,"2016-08-30 21:26:02","2016-08-30 21:26:02"
4397,6000,1419,1419,7419,1,"2016-08-30 21:26:02","2016-08-30 21:26:02"
4398,4000,1327,1327,5327,1,"2016-08-30 21:26:02","2016-08-30 21:26:02"
4399,8000,1595,1595,9595,1,"2016-08-30 21:26:02","2016-08-30 21:26:02"
4400,4000,1231,1231,5231,2,"2016-08-30 21:26:02","2016-08-30 21:26:02"
4401,8900,1547,0,8900,2,"2016-08-30 21:26:02","2016-08-30 21:26:02"
4402,8900,1641,0,8900,2,"2016-08-30 21:26:02","2016-08-30 21:26:02"
4403,8500,1508,1508,10008,1,"2016-08-30 21:26:02","2016-08-30 21:26:02"
4404,5000,1321,1321,6321,2,"2016-08-30 21:26:02","2016-08-30 21:26:02"
4405,8500,1483,0,8500,2,"2016-08-30 21:26:02","2016-08-30 21:26:02"
4406,5000,1414,1414,6414,1,"2016-08-30 21:26:02","2016-08-30 21:26:02"
4407,8900,1477,0,8900,2,"2016-08-30 21:26:02","2016-08-30 21:26:02"
4408,5000,1321,1321,6321,1,"2016-08-30 21:26:02","2016-08-30 21:26:02"
4409,9900,1511,0,9900,2,"2016-08-30 21:26:02","2016-08-30 21:26:02"
4410,8000,1539,0,8000,2,"2016-08-30 21:26:02","2016-08-30 21:26:02"
4411,5000,1360,1360,6360,1,"2016-08-30 21:26:02","2016-08-30 21:26:02"
4412,8900,1476,1476,10376,1,"2016-08-30 21:26:02","2016-08-30 21:26:02"
4413,8500,1471,0,8500,2,"2016-08-30 21:26:02","2016-08-30 21:26:02"
4414,5000,1297,1297,6297,1,"2016-08-30 21:26:02","2016-08-30 21:26:02"
4415,8000,1433,1433,9433,1,"2016-08-30 21:26:02","2016-08-30 21:26:02"
4416,8500,1598,0,8500,2,"2016-08-30 21:26:02","2016-08-30 21:26:02"
4417,4000,1222,1222,5222,1,"2016-08-30 21:26:02","2016-08-30 21:26:02"
4418,8000,1502,0,8000,2,"2016-08-30 21:26:02","2016-08-30 21:26:02"
4419,8000,1486,0,8000,2,"2016-08-30 21:26:02","2016-08-30 21:26:02"
4420,8900,1565,0,8900,2,"2016-08-30 21:26:02","2016-08-30 21:26:02"
4421,9000,1618,1618,10618,1,"2016-08-30 21:26:02","2016-08-30 21:26:02"
4422,8900,1630,0,8900,2,"2016-08-30 21:26:02","2016-08-30 21:26:02"
4423,8000,1585,1585,9585,1,"2016-08-30 21:26:02","2016-08-30 21:26:02"
4424,8000,1493,0,8000,2,"2016-08-30 21:26:02","2016-08-30 21:26:02"
4425,7000,1541,1541,8541,1,"2016-08-30 21:26:02","2016-08-30 21:26:02"
4426,8000,1442,1442,9442,2,"2016-08-30 21:26:02","2016-08-30 21:26:02"
4427,9900,1600,1600,11500,1,"2016-08-30 21:26:02","2016-08-30 21:26:02"
4428,8900,1459,1459,10359,1,"2016-08-30 21:26:02","2016-08-30 21:26:02"
4429,9000,1605,1605,10605,1,"2016-08-30 21:26:02","2016-08-30 21:26:02"
4430,9000,1562,1562,10562,1,"2016-08-30 21:26:02","2016-08-30 21:26:02"
4431,5000,1411,1411,6411,1,"2016-08-30 21:26:02","2016-08-30 21:26:02"
4432,8000,1552,0,8000,2,"2016-08-30 21:26:02","2016-08-30 21:26:02"
4433,8900,1484,0,8900,2,"2016-08-30 21:26:02","2016-08-30 21:26:02"
4434,8500,1459,1459,9959,1,"2016-08-30 21:26:02","2016-08-30 21:26:02"
4435,4000,1306,1306,5306,1,"2016-08-30 21:26:02","2016-08-30 21:26:02"
4436,5000,1255,1255,6255,1,"2016-08-30 21:26:02","2016-08-30 21:26:02"
4437,7000,1350,1350,8350,2,"2016-08-30 21:26:02","2016-08-30 21:26:02"
4438,8900,1482,0,8900,2,"2016-08-30 21:26:02","2016-08-30 21:26:02"
4439,8500,1475,1475,9975,2,"2016-08-30 21:26:02","2016-08-30 21:26:02"
4440,8500,1581,0,8500,2,"2016-08-30 21:26:02","2016-08-30 21:26:02"
4441,8500,1610,0,8500,2,"2016-08-30 21:26:02","2016-08-30 21:26:02"
4442,4000,1293,1293,5293,1,"2016-08-30 21:26:02","2016-08-30 21:26:02"
4443,8900,1596,0,8900,2,"2016-08-30 21:26:02","2016-08-30 21:26:02"
4444,7000,1454,1454,8454,1,"2016-08-30 21:26:02","2016-08-30 21:26:02"
4445,6000,1467,1467,7467,1,"2016-08-30 21:26:02","2016-08-30 21:26:02"
4446,9900,1507,1507,11407,1,"2016-08-30 21:26:02","2016-08-30 21:26:02"
4447,9900,1519,0,9900,2,"2016-08-30 21:26:02","2016-08-30 21:26:02"
4448,8900,1641,1641,10541,1,"2016-08-30 21:26:02","2016-08-30 21:26:02"
4449,6000,1484,1484,7484,1,"2016-08-30 21:26:02","2016-08-30 21:26:02"
4450,8000,1424,0,8000,2,"2016-08-30 21:26:02","2016-08-30 21:26:02"
4451,5000,1395,1395,6395,1,"2016-08-30 21:26:02","2016-08-30 21:26:02"
4452,4000,1355,1355,5355,1,"2016-08-30 21:26:02","2016-08-30 21:26:02"
4453,8000,1509,1509,9509,2,"2016-08-30 21:26:02","2016-08-30 21:26:02"
4454,9900,1539,1539,11439,1,"2016-08-30 21:26:02","2016-08-30 21:26:02"
4455,8900,1617,0,8900,2,"2016-08-30 21:26:02","2016-08-30 21:26:02"
4456,9000,1600,1600,10600,1,"2016-08-30 21:26:02","2016-08-30 21:26:02"
4457,8000,1479,0,8000,2,"2016-08-30 21:26:02","2016-08-30 21:26:02"
4458,8000,1519,1519,9519,2,"2016-08-30 21:26:02","2016-08-30 21:26:02"
4459,9500,1509,1509,11009,1,"2016-08-30 21:26:02","2016-08-30 21:26:02"
4460,8500,1605,0,8500,2,"2016-08-30 21:26:02","2016-08-30 21:26:02"
4461,8000,1451,0,8000,2,"2016-08-30 21:26:02","2016-08-30 21:26:02"
4462,6000,1330,1330,7330,1,"2016-08-30 21:26:02","2016-08-30 21:26:02"
4463,8900,1543,0,8900,2,"2016-08-30 21:26:02","2016-08-30 21:26:02"
4464,8000,1560,1560,9560,1,"2016-08-30 21:26:02","2016-08-30 21:26:02"
4465,8900,1633,0,8900,2,"2016-08-30 21:26:02","2016-08-30 21:26:02"
4466,4000,1394,1394,5394,2,"2016-08-30 21:26:02","2016-08-30 21:26:02"
4467,9000,1563,1563,10563,1,"2016-08-30 21:26:02","2016-08-30 21:26:02"
4468,8500,1577,0,8500,2,"2016-08-30 21:26:02","2016-08-30 21:26:02"
4469,5000,1251,1251,6251,2,"2016-08-30 21:26:02","2016-08-30 21:26:02"
4470,5000,1372,1372,6372,2,"2016-08-30 21:26:02","2016-08-30 21:26:02"
4471,8500,1565,1565,10065,1,"2016-08-30 21:26:02","2016-08-30 21:26:02"
4472,8000,1451,0,8000,2,"2016-08-30 21:26:02","2016-08-30 21:26:02"
4473,8000,1532,0,8000,2,"2016-08-30 21:26:02","2016-08-30 21:26:02"
4474,8500,1588,0,8500,2,"2016-08-30 21:26:02","2016-08-30 21:26:02"
4475,8900,1621,1621,10521,2,"2016-08-30 21:26:02","2016-08-30 21:26:02"
4476,9500,1605,1605,11105,1,"2016-08-30 21:26:02","2016-08-30 21:26:02"
4477,8000,1559,1559,9559,1,"2016-08-30 21:26:02","2016-08-30 21:26:02"
4478,9900,1511,1511,11411,1,"2016-08-30 21:26:02","2016-08-30 21:26:02"
4479,9900,1652,1652,11552,1,"2016-08-30 21:26:02","2016-08-30 21:26:02"
4480,8000,1406,1406,9406,1,"2016-08-30 21:26:02","2016-08-30 21:26:02"
4481,8000,1509,1509,9509,2,"2016-08-30 21:26:02","2016-08-30 21:26:02"
4482,8000,1532,0,8000,2,"2016-08-30 21:26:02","2016-08-30 21:26:02"
4483,4000,1328,1328,5328,1,"2016-08-30 21:26:02","2016-08-30 21:26:02"
4484,8500,1528,0,8500,2,"2016-08-30 21:26:02","2016-08-30 21:26:02"
4485,7000,1538,1538,8538,2,"2016-08-30 21:26:02","2016-08-30 21:26:02"
4486,8000,1581,0,8000,2,"2016-08-30 21:26:02","2016-08-30 21:26:02"
4487,4000,1367,1367,5367,1,"2016-08-30 21:26:02","2016-08-30 21:26:02"
4488,8000,1559,1559,9559,1,"2016-08-30 21:26:02","2016-08-30 21:26:02"
4489,7000,1516,1516,8516,1,"2016-08-30 21:26:02","2016-08-30 21:26:02"
4490,8500,1564,1564,10064,2,"2016-08-30 21:26:02","2016-08-30 21:26:02"
4491,8500,1494,1494,9994,1,"2016-08-30 21:26:02","2016-08-30 21:26:02"
4492,9900,1601,1601,11501,1,"2016-08-30 21:26:02","2016-08-30 21:26:02"
4493,7000,1375,1375,8375,2,"2016-08-30 21:26:02","2016-08-30 21:26:02"
4494,4000,1346,1346,5346,1,"2016-08-30 21:26:02","2016-08-30 21:26:02"
4495,8500,1486,0,8500,2,"2016-08-30 21:26:02","2016-08-30 21:26:02"
4496,8500,1607,1607,10107,2,"2016-08-30 21:26:02","2016-08-30 21:26:02"
4497,8000,1424,0,8000,2,"2016-08-30 21:26:02","2016-08-30 21:26:02"
4498,8500,1437,1437,9937,1,"2016-08-30 21:26:02","2016-08-30 21:26:02"
4499,8000,1589,0,8000,2,"2016-08-30 21:26:02","2016-08-30 21:26:02"
4500,9900,1670,0,9900,2,"2016-08-30 21:26:02","2016-08-30 21:26:02"
4501,8000,1541,1541,9541,1,"2016-08-30 21:26:02","2016-08-30 21:26:02"
4502,4000,1300,1300,5300,2,"2016-08-30 21:26:02","2016-08-30 21:26:02"
4503,8000,1406,1406,9406,1,"2016-08-30 21:26:02","2016-08-30 21:26:02"
4504,8500,1452,0,8500,2,"2016-08-30 21:26:02","2016-08-30 21:26:02"
4505,9900,1549,1549,11449,1,"2016-08-30 21:26:02","2016-08-30 21:26:02"
4506,6000,1429,1429,7429,1,"2016-08-30 21:26:03","2016-08-30 21:26:03"
4507,9500,1544,1544,11044,1,"2016-08-30 21:26:03","2016-08-30 21:26:03"
4508,8000,1541,0,8000,2,"2016-08-30 21:26:03","2016-08-30 21:26:03"
4509,8000,1586,1586,9586,2,"2016-08-30 21:26:03","2016-08-30 21:26:03"
4510,8900,1618,0,8900,2,"2016-08-30 21:26:03","2016-08-30 21:26:03"
4511,4000,1211,1211,5211,1,"2016-08-30 21:26:03","2016-08-30 21:26:03"
4512,9900,1690,1690,11590,2,"2016-08-30 21:26:03","2016-08-30 21:26:03"
4513,4000,1348,1348,5348,2,"2016-08-30 21:26:03","2016-08-30 21:26:03"
4514,8000,1549,0,8000,2,"2016-08-30 21:26:03","2016-08-30 21:26:03"
4515,8500,1601,0,8500,2,"2016-08-30 21:26:03","2016-08-30 21:26:03"
4516,8900,1485,1485,10385,1,"2016-08-30 21:26:03","2016-08-30 21:26:03"
4517,8000,1486,0,8000,2,"2016-08-30 21:26:03","2016-08-30 21:26:03"
4518,8000,1538,1538,9538,2,"2016-08-30 21:26:03","2016-08-30 21:26:03"
4519,8500,1621,0,8500,2,"2016-08-30 21:26:03","2016-08-30 21:26:03"
4520,8000,1494,0,8000,2,"2016-08-30 21:26:03","2016-08-30 21:26:03"
4521,8500,1429,1429,9929,2,"2016-08-30 21:26:03","2016-08-30 21:26:03"
4522,8000,1454,0,8000,2,"2016-08-30 21:26:03","2016-08-30 21:26:03"
4523,8000,1550,0,8000,2,"2016-08-30 21:26:03","2016-08-30 21:26:03"
4524,8000,1407,1407,9407,1,"2016-08-30 21:26:03","2016-08-30 21:26:03"
4525,9500,1515,1515,11015,1,"2016-08-30 21:26:03","2016-08-30 21:26:03"
4526,8500,1594,1594,10094,1,"2016-08-30 21:26:03","2016-08-30 21:26:03"
4527,9900,1637,0,9900,2,"2016-08-30 21:26:03","2016-08-30 21:26:03"
4528,8000,1565,0,8000,2,"2016-08-30 21:26:03","2016-08-30 21:26:03"
4529,4000,1290,1290,5290,2,"2016-08-30 21:26:03","2016-08-30 21:26:03"
4530,8500,1478,1478,9978,2,"2016-08-30 21:26:03","2016-08-30 21:26:03"
4531,9900,1508,0,9900,2,"2016-08-30 21:26:03","2016-08-30 21:26:03"
4532,8900,1570,0,8900,2,"2016-08-30 21:26:03","2016-08-30 21:26:03"
4533,8000,1439,0,8000,2,"2016-08-30 21:26:03","2016-08-30 21:26:03"
4534,8500,1530,1530,10030,2,"2016-08-30 21:26:03","2016-08-30 21:26:03"
4535,8000,1402,1402,9402,1,"2016-08-30 21:26:03","2016-08-30 21:26:03"
4536,8000,1586,0,8000,2,"2016-08-30 21:26:03","2016-08-30 21:26:03"
4537,8000,1446,0,8000,2,"2016-08-30 21:26:03","2016-08-30 21:26:03"
4538,4000,1392,1392,5392,2,"2016-08-30 21:26:03","2016-08-30 21:26:03"
4539,8500,1430,1430,9930,1,"2016-08-30 21:26:03","2016-08-30 21:26:03"
4540,4000,1351,1351,5351,2,"2016-08-30 21:26:03","2016-08-30 21:26:03"
4541,8000,1452,1452,9452,1,"2016-08-30 21:26:03","2016-08-30 21:26:03"
4542,8000,1519,1519,9519,2,"2016-08-30 21:26:03","2016-08-30 21:26:03"
4543,4000,1220,1220,5220,2,"2016-08-30 21:26:03","2016-08-30 21:26:03"
4544,4000,1221,1221,5221,1,"2016-08-30 21:26:03","2016-08-30 21:26:03"
4545,8900,1569,1569,10469,1,"2016-08-30 21:26:03","2016-08-30 21:26:03"
4546,8000,1522,0,8000,2,"2016-08-30 21:26:03","2016-08-30 21:26:03"
4547,8000,1427,1427,9427,2,"2016-08-30 21:26:03","2016-08-30 21:26:03"
4548,8000,1497,0,8000,2,"2016-08-30 21:26:03","2016-08-30 21:26:03"
4549,9900,1542,1542,11442,1,"2016-08-30 21:26:03","2016-08-30 21:26:03"
4550,8500,1488,1488,9988,1,"2016-08-30 21:26:03","2016-08-30 21:26:03"
4551,8000,1422,0,8000,2,"2016-08-30 21:26:03","2016-08-30 21:26:03"
4552,8500,1495,1495,9995,1,"2016-08-30 21:26:03","2016-08-30 21:26:03"
4553,5000,1362,1362,6362,1,"2016-08-30 21:26:03","2016-08-30 21:26:03"
4554,8000,1570,0,8000,2,"2016-08-30 21:26:03","2016-08-30 21:26:03"
4555,8000,1459,0,8000,2,"2016-08-30 21:26:03","2016-08-30 21:26:03"
4556,5000,1306,1306,6306,1,"2016-08-30 21:26:03","2016-08-30 21:26:03"
4557,8900,1534,0,8900,2,"2016-08-30 21:26:03","2016-08-30 21:26:03"
4558,9900,1533,0,9900,2,"2016-08-30 21:26:03","2016-08-30 21:26:03"
4559,8000,1529,0,8000,2,"2016-08-30 21:26:03","2016-08-30 21:26:03"
4560,8500,1580,0,8500,2,"2016-08-30 21:26:03","2016-08-30 21:26:03"
4561,5000,1269,1269,6269,1,"2016-08-30 21:26:03","2016-08-30 21:26:03"
4562,8000,1430,0,8000,2,"2016-08-30 21:26:03","2016-08-30 21:26:03"
4563,9900,1625,1625,11525,1,"2016-08-30 21:26:03","2016-08-30 21:26:03"
4564,7000,1380,1380,8380,1,"2016-08-30 21:26:03","2016-08-30 21:26:03"
4565,8500,1564,1564,10064,1,"2016-08-30 21:26:03","2016-08-30 21:26:03"
4566,8500,1570,1570,10070,1,"2016-08-30 21:26:03","2016-08-30 21:26:03"
4567,8500,1510,1510,10010,1,"2016-08-30 21:26:03","2016-08-30 21:26:03"
4568,5000,1369,1369,6369,1,"2016-08-30 21:26:03","2016-08-30 21:26:03"
4569,5000,1393,1393,6393,1,"2016-08-30 21:26:03","2016-08-30 21:26:03"
4570,8900,1547,1547,10447,2,"2016-08-30 21:26:03","2016-08-30 21:26:03"
4571,8000,1482,0,8000,2,"2016-08-30 21:26:03","2016-08-30 21:26:03"
4572,8900,1526,1526,10426,2,"2016-08-30 21:26:03","2016-08-30 21:26:03"
4573,9900,1649,1649,11549,1,"2016-08-30 21:26:03","2016-08-30 21:26:03"
4574,8000,1595,1595,9595,1,"2016-08-30 21:26:03","2016-08-30 21:26:03"
4575,4000,1241,1241,5241,1,"2016-08-30 21:26:03","2016-08-30 21:26:03"
4576,8000,1583,0,8000,2,"2016-08-30 21:26:03","2016-08-30 21:26:03"
4577,5000,1335,1335,6335,1,"2016-08-30 21:26:03","2016-08-30 21:26:03"
4578,4000,1285,1285,5285,1,"2016-08-30 21:26:03","2016-08-30 21:26:03"
4579,8500,1525,0,8500,2,"2016-08-30 21:26:03","2016-08-30 21:26:03"
4580,8000,1463,0,8000,2,"2016-08-30 21:26:03","2016-08-30 21:26:03"
4581,5000,1400,1400,6400,1,"2016-08-30 21:26:03","2016-08-30 21:26:03"
4582,8500,1562,0,8500,2,"2016-08-30 21:26:03","2016-08-30 21:26:03"
4583,8900,1486,1486,10386,2,"2016-08-30 21:26:03","2016-08-30 21:26:03"
4584,5000,1386,1386,6386,1,"2016-08-30 21:26:03","2016-08-30 21:26:03"
4585,5000,1356,1356,6356,1,"2016-08-30 21:26:03","2016-08-30 21:26:03"
4586,9000,1644,1644,10644,1,"2016-08-30 21:26:03","2016-08-30 21:26:03"
4587,8000,1505,0,8000,2,"2016-08-30 21:26:03","2016-08-30 21:26:03"
4588,8000,1567,1567,9567,1,"2016-08-30 21:26:03","2016-08-30 21:26:03"
4589,9500,1555,1555,11055,1,"2016-08-30 21:26:03","2016-08-30 21:26:03"
4590,8000,1447,0,8000,2,"2016-08-30 21:26:03","2016-08-30 21:26:03"
4591,8900,1463,1463,10363,2,"2016-08-30 21:26:03","2016-08-30 21:26:03"
4592,8900,1642,0,8900,2,"2016-08-30 21:26:03","2016-08-30 21:26:03"
4593,6000,1430,1430,7430,1,"2016-08-30 21:26:03","2016-08-30 21:26:03"
4594,8500,1612,1612,10112,1,"2016-08-30 21:26:03","2016-08-30 21:26:03"
4595,8900,1632,0,8900,2,"2016-08-30 21:26:03","2016-08-30 21:26:03"
4596,8000,1489,1489,9489,2,"2016-08-30 21:26:03","2016-08-30 21:26:03"
4597,7000,1442,1442,8442,1,"2016-08-30 21:26:03","2016-08-30 21:26:03"
4598,5000,1438,1438,6438,1,"2016-08-30 21:26:03","2016-08-30 21:26:03"
4599,8500,1517,0,8500,2,"2016-08-30 21:26:03","2016-08-30 21:26:03"
4600,6000,1464,1464,7464,1,"2016-08-30 21:26:03","2016-08-30 21:26:03"
4601,4000,1290,1290,5290,2,"2016-08-30 21:26:03","2016-08-30 21:26:03"
4602,9900,1537,0,9900,2,"2016-08-30 21:26:03","2016-08-30 21:26:03"
4603,8000,1450,0,8000,2,"2016-08-30 21:26:03","2016-08-30 21:26:03"
4604,7000,1378,1378,8378,1,"2016-08-30 21:26:03","2016-08-30 21:26:03"
4605,4000,1247,1247,5247,2,"2016-08-30 21:26:03","2016-08-30 21:26:03"
4606,8900,1505,0,8900,2,"2016-08-30 21:26:03","2016-08-30 21:26:03"
4607,8900,1632,1632,10532,1,"2016-08-30 21:26:03","2016-08-30 21:26:03"
4608,8500,1624,1624,10124,1,"2016-08-30 21:26:03","2016-08-30 21:26:03"
4609,7000,1373,1373,8373,1,"2016-08-30 21:26:03","2016-08-30 21:26:03"
4610,8900,1537,0,8900,2,"2016-08-30 21:26:03","2016-08-30 21:26:03"
4611,8900,1573,0,8900,2,"2016-08-30 21:26:03","2016-08-30 21:26:03"
4612,8000,1480,0,8000,2,"2016-08-30 21:26:03","2016-08-30 21:26:03"
4613,8900,1478,0,8900,2,"2016-08-30 21:26:03","2016-08-30 21:26:03"
4614,8000,1507,1507,9507,1,"2016-08-30 21:26:03","2016-08-30 21:26:03"
4615,5000,1328,1328,6328,2,"2016-08-30 21:26:03","2016-08-30 21:26:03"
4616,8900,1610,0,8900,2,"2016-08-30 21:26:03","2016-08-30 21:26:03"
4617,9000,1521,1521,10521,1,"2016-08-30 21:26:03","2016-08-30 21:26:03"
4618,9500,1547,1547,11047,2,"2016-08-30 21:26:03","2016-08-30 21:26:03"
4619,8000,1440,1440,9440,2,"2016-08-30 21:26:03","2016-08-30 21:26:03"
4620,8500,1578,0,8500,2,"2016-08-30 21:26:03","2016-08-30 21:26:03"
4621,8900,1519,0,8900,2,"2016-08-30 21:26:03","2016-08-30 21:26:03"
4622,8000,1498,0,8000,2,"2016-08-30 21:26:03","2016-08-30 21:26:03"
4623,4000,1318,1318,5318,1,"2016-08-30 21:26:03","2016-08-30 21:26:03"
4624,5000,1370,1370,6370,2,"2016-08-30 21:26:03","2016-08-30 21:26:03"
4625,9900,1499,1499,11399,1,"2016-08-30 21:26:03","2016-08-30 21:26:03"
4626,8000,1413,0,8000,2,"2016-08-30 21:26:03","2016-08-30 21:26:03"
4627,8000,1462,0,8000,2,"2016-08-30 21:26:03","2016-08-30 21:26:03"
4628,6000,1374,1374,7374,1,"2016-08-30 21:26:03","2016-08-30 21:26:03"
4629,9900,1558,0,9900,2,"2016-08-30 21:26:03","2016-08-30 21:26:03"
4630,8000,1462,1462,9462,1,"2016-08-30 21:26:03","2016-08-30 21:26:03"
4631,8900,1559,1559,10459,1,"2016-08-30 21:26:03","2016-08-30 21:26:03"
4632,8000,1517,0,8000,2,"2016-08-30 21:26:03","2016-08-30 21:26:03"
4633,8000,1502,0,8000,2,"2016-08-30 21:26:03","2016-08-30 21:26:03"
4634,8900,1580,1580,10480,1,"2016-08-30 21:26:03","2016-08-30 21:26:03"
4635,8500,1611,0,8500,2,"2016-08-30 21:26:03","2016-08-30 21:26:03"
4636,8000,1545,1545,9545,1,"2016-08-30 21:26:03","2016-08-30 21:26:03"
4637,9000,1484,0,9000,2,"2016-08-30 21:26:03","2016-08-30 21:26:03"
4638,8500,1541,0,8500,2,"2016-08-30 21:26:03","2016-08-30 21:26:03"
4639,8500,1479,0,8500,2,"2016-08-30 21:26:03","2016-08-30 21:26:03"
4640,8000,1518,1518,9518,1,"2016-08-30 21:26:03","2016-08-30 21:26:03"
4641,4000,1241,1241,5241,1,"2016-08-30 21:26:03","2016-08-30 21:26:03"
4642,4000,1344,1344,5344,1,"2016-08-30 21:26:03","2016-08-30 21:26:03"
4643,9900,1616,1616,11516,1,"2016-08-30 21:26:03","2016-08-30 21:26:03"
4644,8500,1434,0,8500,2,"2016-08-30 21:26:03","2016-08-30 21:26:03"
4645,8000,1590,1590,9590,1,"2016-08-30 21:26:03","2016-08-30 21:26:03"
4646,9500,1571,0,9500,2,"2016-08-30 21:26:03","2016-08-30 21:26:03"
4647,8900,1495,0,8900,2,"2016-08-30 21:26:03","2016-08-30 21:26:03"
4648,9000,1532,0,9000,2,"2016-08-30 21:26:03","2016-08-30 21:26:03"
4649,8500,1575,1575,10075,1,"2016-08-30 21:26:03","2016-08-30 21:26:03"
4650,8000,1539,0,8000,2,"2016-08-30 21:26:03","2016-08-30 21:26:03"
4651,7000,1388,1388,8388,1,"2016-08-30 21:26:03","2016-08-30 21:26:03"
4652,8500,1563,0,8500,2,"2016-08-30 21:26:03","2016-08-30 21:26:03"
4653,8500,1491,1491,9991,1,"2016-08-30 21:26:03","2016-08-30 21:26:03"
4654,8000,1402,0,8000,2,"2016-08-30 21:26:03","2016-08-30 21:26:03"
4655,8000,1529,1529,9529,1,"2016-08-30 21:26:03","2016-08-30 21:26:03"
4656,8900,1499,1499,10399,2,"2016-08-30 21:26:03","2016-08-30 21:26:03"
4657,5000,1277,1277,6277,2,"2016-08-30 21:26:03","2016-08-30 21:26:03"
4658,5000,1343,1343,6343,2,"2016-08-30 21:26:03","2016-08-30 21:26:03"
4659,8900,1580,0,8900,2,"2016-08-30 21:26:03","2016-08-30 21:26:03"
4660,9900,1683,1683,11583,2,"2016-08-30 21:26:03","2016-08-30 21:26:03"
4661,8000,1544,0,8000,2,"2016-08-30 21:26:03","2016-08-30 21:26:03"
4662,9000,1627,1627,10627,1,"2016-08-30 21:26:03","2016-08-30 21:26:03"
4663,9900,1543,0,9900,2,"2016-08-30 21:26:03","2016-08-30 21:26:03"
4664,8500,1546,0,8500,2,"2016-08-30 21:26:03","2016-08-30 21:26:03"
4665,9500,1621,1621,11121,1,"2016-08-30 21:26:03","2016-08-30 21:26:03"
4666,8500,1616,1616,10116,1,"2016-08-30 21:26:03","2016-08-30 21:26:03"
4667,5000,1412,1412,6412,1,"2016-08-30 21:26:03","2016-08-30 21:26:03"
4668,5000,1257,1257,6257,1,"2016-08-30 21:26:03","2016-08-30 21:26:03"
4669,9500,1597,1597,11097,1,"2016-08-30 21:26:03","2016-08-30 21:26:03"
4670,8900,1477,0,8900,2,"2016-08-30 21:26:03","2016-08-30 21:26:03"
4671,8000,1478,0,8000,2,"2016-08-30 21:26:03","2016-08-30 21:26:03"
4672,4000,1220,1220,5220,1,"2016-08-30 21:26:03","2016-08-30 21:26:03"
4673,9000,1561,1561,10561,1,"2016-08-30 21:26:03","2016-08-30 21:26:03"
4674,9000,1609,1609,10609,1,"2016-08-30 21:26:03","2016-08-30 21:26:03"
4675,8500,1555,0,8500,2,"2016-08-30 21:26:03","2016-08-30 21:26:03"
4676,9900,1619,0,9900,2,"2016-08-30 21:26:03","2016-08-30 21:26:03"
4677,7000,1362,1362,8362,1,"2016-08-30 21:26:03","2016-08-30 21:26:03"
4678,8000,1571,0,8000,2,"2016-08-30 21:26:03","2016-08-30 21:26:03"
4679,8000,1432,1432,9432,2,"2016-08-30 21:26:03","2016-08-30 21:26:03"
4680,4000,1351,1351,5351,1,"2016-08-30 21:26:03","2016-08-30 21:26:03"
4681,4000,1367,1367,5367,1,"2016-08-30 21:26:03","2016-08-30 21:26:03"
4682,8000,1421,0,8000,2,"2016-08-30 21:26:03","2016-08-30 21:26:03"
4683,8000,1451,1451,9451,2,"2016-08-30 21:26:03","2016-08-30 21:26:03"
4684,8900,1532,1532,10432,1,"2016-08-30 21:26:03","2016-08-30 21:26:03"
4685,9500,1582,1582,11082,1,"2016-08-30 21:26:03","2016-08-30 21:26:03"
4686,8500,1426,1426,9926,2,"2016-08-30 21:26:03","2016-08-30 21:26:03"
4687,8900,1583,0,8900,2,"2016-08-30 21:26:03","2016-08-30 21:26:03"
4688,8900,1527,1527,10427,2,"2016-08-30 21:26:03","2016-08-30 21:26:03"
4689,5000,1254,1254,6254,1,"2016-08-30 21:26:03","2016-08-30 21:26:03"
4690,4000,1379,1379,5379,2,"2016-08-30 21:26:03","2016-08-30 21:26:03"
4691,9900,1556,1556,11456,1,"2016-08-30 21:26:03","2016-08-30 21:26:03"
4692,5000,1399,1399,6399,1,"2016-08-30 21:26:03","2016-08-30 21:26:03"
4693,9000,1629,1629,10629,1,"2016-08-30 21:26:03","2016-08-30 21:26:03"
4694,9900,1600,0,9900,2,"2016-08-30 21:26:03","2016-08-30 21:26:03"
4695,4000,1316,1316,5316,2,"2016-08-30 21:26:03","2016-08-30 21:26:03"
4696,8500,1508,0,8500,2,"2016-08-30 21:26:03","2016-08-30 21:26:03"
4697,4000,1384,1384,5384,1,"2016-08-30 21:26:03","2016-08-30 21:26:03"
4698,8900,1634,0,8900,2,"2016-08-30 21:26:03","2016-08-30 21:26:03"
4699,9000,1649,1649,10649,1,"2016-08-30 21:26:03","2016-08-30 21:26:03"
4700,8500,1503,0,8500,2,"2016-08-30 21:26:03","2016-08-30 21:26:03"
4701,8500,1461,0,8500,2,"2016-08-30 21:26:03","2016-08-30 21:26:03"
4702,8000,1439,0,8000,2,"2016-08-30 21:26:03","2016-08-30 21:26:03"
4703,9000,1555,0,9000,2,"2016-08-30 21:26:03","2016-08-30 21:26:03"
4704,6000,1306,1306,7306,2,"2016-08-30 21:26:03","2016-08-30 21:26:03"
4705,8900,1598,1598,10498,1,"2016-08-30 21:26:03","2016-08-30 21:26:03"
4706,9000,1495,1495,10495,1,"2016-08-30 21:26:03","2016-08-30 21:26:03"
4707,8000,1428,0,8000,2,"2016-08-30 21:26:03","2016-08-30 21:26:03"
4708,5000,1271,1271,6271,1,"2016-08-30 21:26:03","2016-08-30 21:26:03"
4709,8000,1519,1519,9519,1,"2016-08-30 21:26:03","2016-08-30 21:26:03"
4710,8500,1624,0,8500,2,"2016-08-30 21:26:03","2016-08-30 21:26:03"
4711,8900,1517,0,8900,2,"2016-08-30 21:26:03","2016-08-30 21:26:03"
4712,8900,1555,0,8900,2,"2016-08-30 21:26:03","2016-08-30 21:26:03"
4713,7000,1412,1412,8412,1,"2016-08-30 21:26:03","2016-08-30 21:26:03"
4714,8900,1489,0,8900,2,"2016-08-30 21:26:03","2016-08-30 21:26:03"
4715,8000,1485,0,8000,2,"2016-08-30 21:26:03","2016-08-30 21:26:03"
4716,8500,1445,0,8500,2,"2016-08-30 21:26:03","2016-08-30 21:26:03"
4717,7000,1390,1390,8390,1,"2016-08-30 21:26:03","2016-08-30 21:26:03"
4718,9500,1510,1510,11010,1,"2016-08-30 21:26:03","2016-08-30 21:26:03"
4719,8900,1582,0,8900,2,"2016-08-30 21:26:03","2016-08-30 21:26:03"
4720,8000,1491,1491,9491,1,"2016-08-30 21:26:03","2016-08-30 21:26:03"
4721,8000,1479,0,8000,2,"2016-08-30 21:26:03","2016-08-30 21:26:03"
4722,8500,1493,0,8500,2,"2016-08-30 21:26:03","2016-08-30 21:26:03"
4723,6000,1367,1367,7367,2,"2016-08-30 21:26:03","2016-08-30 21:26:03"
4724,8000,1598,1598,9598,2,"2016-08-30 21:26:03","2016-08-30 21:26:03"
4725,4000,1202,1202,5202,1,"2016-08-30 21:26:03","2016-08-30 21:26:03"
4726,8000,1518,0,8000,2,"2016-08-30 21:26:03","2016-08-30 21:26:03"
4727,8000,1587,1587,9587,1,"2016-08-30 21:26:03","2016-08-30 21:26:03"
4728,5000,1327,1327,6327,1,"2016-08-30 21:26:03","2016-08-30 21:26:03"
4729,7000,1384,1384,8384,1,"2016-08-30 21:26:03","2016-08-30 21:26:03"
4730,9900,1495,1495,11395,1,"2016-08-30 21:26:03","2016-08-30 21:26:03"
4731,8900,1631,0,8900,2,"2016-08-30 21:26:03","2016-08-30 21:26:03"
4732,8900,1591,1591,10491,2,"2016-08-30 21:26:03","2016-08-30 21:26:03"
4733,5000,1300,1300,6300,2,"2016-08-30 21:26:03","2016-08-30 21:26:03"
4734,8000,1414,1414,9414,1,"2016-08-30 21:26:03","2016-08-30 21:26:03"
4735,8000,1417,1417,9417,2,"2016-08-30 21:26:03","2016-08-30 21:26:03"
4736,9500,1654,1654,11154,1,"2016-08-30 21:26:03","2016-08-30 21:26:03"
4737,7000,1450,1450,8450,1,"2016-08-30 21:26:03","2016-08-30 21:26:03"
4738,8900,1523,0,8900,2,"2016-08-30 21:26:03","2016-08-30 21:26:03"
4739,8000,1425,0,8000,2,"2016-08-30 21:26:03","2016-08-30 21:26:03"
4740,8900,1475,1475,10375,1,"2016-08-30 21:26:03","2016-08-30 21:26:03"
4741,9900,1647,1647,11547,1,"2016-08-30 21:26:03","2016-08-30 21:26:03"
4742,9900,1609,0,9900,2,"2016-08-30 21:26:03","2016-08-30 21:26:03"
4743,8900,1494,1494,10394,1,"2016-08-30 21:26:03","2016-08-30 21:26:03"
4744,8000,1576,0,8000,2,"2016-08-30 21:26:03","2016-08-30 21:26:03"
4745,8000,1402,0,8000,2,"2016-08-30 21:26:03","2016-08-30 21:26:03"
4746,4000,1262,1262,5262,1,"2016-08-30 21:26:03","2016-08-30 21:26:03"
4747,4000,1344,1344,5344,1,"2016-08-30 21:26:03","2016-08-30 21:26:03"
4748,8000,1485,1485,9485,1,"2016-08-30 21:26:03","2016-08-30 21:26:03"
4749,8000,1579,0,8000,2,"2016-08-30 21:26:03","2016-08-30 21:26:03"
4750,5000,1379,1379,6379,1,"2016-08-30 21:26:03","2016-08-30 21:26:03"
4751,8500,1480,1480,9980,2,"2016-08-30 21:26:03","2016-08-30 21:26:03"
4752,4000,1326,1326,5326,1,"2016-08-30 21:26:03","2016-08-30 21:26:03"
4753,8000,1512,0,8000,2,"2016-08-30 21:26:03","2016-08-30 21:26:03"
4754,8900,1551,0,8900,2,"2016-08-30 21:26:03","2016-08-30 21:26:03"
4755,7000,1444,1444,8444,2,"2016-08-30 21:26:03","2016-08-30 21:26:03"
4756,4000,1328,1328,5328,1,"2016-08-30 21:26:03","2016-08-30 21:26:03"
4757,8500,1568,1568,10068,2,"2016-08-30 21:26:03","2016-08-30 21:26:03"
4758,8900,1455,0,8900,2,"2016-08-30 21:26:03","2016-08-30 21:26:03"
4759,5000,1446,1446,6446,1,"2016-08-30 21:26:03","2016-08-30 21:26:03"
4760,6000,1382,1382,7382,1,"2016-08-30 21:26:03","2016-08-30 21:26:03"
4761,6000,1407,1407,7407,2,"2016-08-30 21:26:03","2016-08-30 21:26:03"
4762,8500,1583,1583,10083,1,"2016-08-30 21:26:03","2016-08-30 21:26:03"
4763,8900,1610,1610,10510,2,"2016-08-30 21:26:03","2016-08-30 21:26:03"
4764,9900,1510,1510,11410,1,"2016-08-30 21:26:03","2016-08-30 21:26:03"
4765,4000,1341,1341,5341,2,"2016-08-30 21:26:03","2016-08-30 21:26:03"
4766,4000,1359,1359,5359,1,"2016-08-30 21:26:03","2016-08-30 21:26:03"
4767,4000,1214,1214,5214,1,"2016-08-30 21:26:03","2016-08-30 21:26:03"
4768,9900,1674,1674,11574,2,"2016-08-30 21:26:03","2016-08-30 21:26:03"
4769,8000,1459,1459,9459,2,"2016-08-30 21:26:03","2016-08-30 21:26:03"
4770,8000,1439,0,8000,2,"2016-08-30 21:26:03","2016-08-30 21:26:03"
4771,8000,1462,0,8000,2,"2016-08-30 21:26:03","2016-08-30 21:26:03"
4772,7000,1510,1510,8510,2,"2016-08-30 21:26:03","2016-08-30 21:26:03"
4773,8500,1578,0,8500,2,"2016-08-30 21:26:03","2016-08-30 21:26:03"
4774,8000,1451,0,8000,2,"2016-08-30 21:26:03","2016-08-30 21:26:03"
4775,6000,1407,1407,7407,1,"2016-08-30 21:26:03","2016-08-30 21:26:03"
4776,5000,1338,1338,6338,2,"2016-08-30 21:26:03","2016-08-30 21:26:03"
4777,8500,1449,0,8500,2,"2016-08-30 21:26:03","2016-08-30 21:26:03"
4778,8000,1516,1516,9516,2,"2016-08-30 21:26:03","2016-08-30 21:26:03"
4779,9900,1517,1517,11417,2,"2016-08-30 21:26:03","2016-08-30 21:26:03"
4780,8900,1550,0,8900,2,"2016-08-30 21:26:03","2016-08-30 21:26:03"
4781,9900,1585,1585,11485,1,"2016-08-30 21:26:03","2016-08-30 21:26:03"
4782,5000,1437,1437,6437,1,"2016-08-30 21:26:03","2016-08-30 21:26:03"
4783,8000,1415,1415,9415,2,"2016-08-30 21:26:03","2016-08-30 21:26:03"
4784,7000,1445,1445,8445,2,"2016-08-30 21:26:03","2016-08-30 21:26:03"
4785,9900,1572,0,9900,2,"2016-08-30 21:26:03","2016-08-30 21:26:03"
4786,8000,1499,1499,9499,1,"2016-08-30 21:26:03","2016-08-30 21:26:03"
4787,8900,1568,0,8900,2,"2016-08-30 21:26:03","2016-08-30 21:26:03"
4788,8000,1571,1571,9571,2,"2016-08-30 21:26:03","2016-08-30 21:26:03"
4789,4000,1386,1386,5386,1,"2016-08-30 21:26:03","2016-08-30 21:26:03"
4790,8000,1497,0,8000,2,"2016-08-30 21:26:03","2016-08-30 21:26:03"
4791,7000,1374,1374,8374,2,"2016-08-30 21:26:03","2016-08-30 21:26:03"
4792,8500,1607,1607,10107,1,"2016-08-30 21:26:03","2016-08-30 21:26:03"
4793,8500,1566,0,8500,2,"2016-08-30 21:26:03","2016-08-30 21:26:03"
4794,8000,1468,0,8000,2,"2016-08-30 21:26:03","2016-08-30 21:26:03"
4795,5000,1268,1268,6268,2,"2016-08-30 21:26:03","2016-08-30 21:26:03"
4796,8000,1407,0,8000,2,"2016-08-30 21:26:03","2016-08-30 21:26:03"
4797,8900,1459,1459,10359,1,"2016-08-30 21:26:03","2016-08-30 21:26:03"
4798,9000,1490,1490,10490,1,"2016-08-30 21:26:03","2016-08-30 21:26:03"
4799,8000,1487,1487,9487,1,"2016-08-30 21:26:03","2016-08-30 21:26:03"
4800,4000,1265,1265,5265,1,"2016-08-30 21:26:03","2016-08-30 21:26:03"
4801,8000,1406,1406,9406,1,"2016-08-30 21:26:03","2016-08-30 21:26:03"
4802,8900,1502,1502,10402,1,"2016-08-30 21:26:03","2016-08-30 21:26:03"
4803,8000,1564,1564,9564,1,"2016-08-30 21:26:03","2016-08-30 21:26:03"
4804,9000,1628,0,9000,2,"2016-08-30 21:26:03","2016-08-30 21:26:03"
4805,7000,1499,1499,8499,2,"2016-08-30 21:26:03","2016-08-30 21:26:03"
4806,8000,1545,1545,9545,1,"2016-08-30 21:26:03","2016-08-30 21:26:03"
4807,8000,1586,0,8000,2,"2016-08-30 21:26:03","2016-08-30 21:26:03"
4808,9500,1668,1668,11168,1,"2016-08-30 21:26:03","2016-08-30 21:26:03"
4809,5000,1370,1370,6370,1,"2016-08-30 21:26:03","2016-08-30 21:26:03"
4810,4000,1254,1254,5254,1,"2016-08-30 21:26:03","2016-08-30 21:26:03"
4811,7000,1365,1365,8365,1,"2016-08-30 21:26:03","2016-08-30 21:26:03"
4812,8000,1577,1577,9577,1,"2016-08-30 21:26:03","2016-08-30 21:26:03"
4813,9900,1642,1642,11542,1,"2016-08-30 21:26:03","2016-08-30 21:26:03"
4814,8000,1557,0,8000,2,"2016-08-30 21:26:03","2016-08-30 21:26:03"
4815,8000,1489,1489,9489,1,"2016-08-30 21:26:03","2016-08-30 21:26:03"
4816,8000,1532,0,8000,2,"2016-08-30 21:26:03","2016-08-30 21:26:03"
4817,8000,1456,1456,9456,1,"2016-08-30 21:26:03","2016-08-30 21:26:03"
4818,8500,1470,1470,9970,1,"2016-08-30 21:26:03","2016-08-30 21:26:03"
4819,9900,1649,1649,11549,1,"2016-08-30 21:26:04","2016-08-30 21:26:04"
4820,8500,1508,1508,10008,1,"2016-08-30 21:26:04","2016-08-30 21:26:04"
4821,9500,1608,1608,11108,1,"2016-08-30 21:26:04","2016-08-30 21:26:04"
4822,8000,1497,0,8000,2,"2016-08-30 21:26:04","2016-08-30 21:26:04"
4823,9900,1567,1567,11467,1,"2016-08-30 21:26:04","2016-08-30 21:26:04"
4824,8000,1512,0,8000,2,"2016-08-30 21:26:04","2016-08-30 21:26:04"
4825,8000,1448,0,8000,2,"2016-08-30 21:26:04","2016-08-30 21:26:04"
4826,8900,1449,1449,10349,1,"2016-08-30 21:26:04","2016-08-30 21:26:04"
4827,8900,1575,1575,10475,1,"2016-08-30 21:26:04","2016-08-30 21:26:04"
4828,9900,1503,1503,11403,1,"2016-08-30 21:26:04","2016-08-30 21:26:04"
4829,8000,1548,0,8000,2,"2016-08-30 21:26:04","2016-08-30 21:26:04"
4830,5000,1416,1416,6416,2,"2016-08-30 21:26:04","2016-08-30 21:26:04"
4831,8000,1552,1552,9552,2,"2016-08-30 21:26:04","2016-08-30 21:26:04"
4832,8000,1580,1580,9580,1,"2016-08-30 21:26:04","2016-08-30 21:26:04"
4833,8000,1437,1437,9437,1,"2016-08-30 21:26:04","2016-08-30 21:26:04"
4834,8000,1432,1432,9432,1,"2016-08-30 21:26:04","2016-08-30 21:26:04"
4835,4000,1258,1258,5258,1,"2016-08-30 21:26:04","2016-08-30 21:26:04"
4836,8000,1410,0,8000,2,"2016-08-30 21:26:04","2016-08-30 21:26:04"
4837,5000,1379,1379,6379,2,"2016-08-30 21:26:04","2016-08-30 21:26:04"
4838,5000,1355,1355,6355,1,"2016-08-30 21:26:04","2016-08-30 21:26:04"
4839,9900,1609,1609,11509,1,"2016-08-30 21:26:04","2016-08-30 21:26:04"
4840,8500,1607,0,8500,2,"2016-08-30 21:26:04","2016-08-30 21:26:04"
4841,8500,1483,1483,9983,2,"2016-08-30 21:26:04","2016-08-30 21:26:04"
4842,4000,1228,1228,5228,2,"2016-08-30 21:26:04","2016-08-30 21:26:04"
4843,4000,1381,1381,5381,2,"2016-08-30 21:26:04","2016-08-30 21:26:04"
4844,8900,1619,1619,10519,2,"2016-08-30 21:26:04","2016-08-30 21:26:04"
4845,8000,1554,1554,9554,1,"2016-08-30 21:26:04","2016-08-30 21:26:04"
4846,5000,1324,1324,6324,1,"2016-08-30 21:26:04","2016-08-30 21:26:04"
4847,8000,1430,1430,9430,1,"2016-08-30 21:26:04","2016-08-30 21:26:04"
4848,6000,1307,1307,7307,1,"2016-08-30 21:26:04","2016-08-30 21:26:04"
4849,8900,1606,1606,10506,1,"2016-08-30 21:26:04","2016-08-30 21:26:04"
4850,8500,1515,0,8500,2,"2016-08-30 21:26:04","2016-08-30 21:26:04"
4851,8500,1594,1594,10094,1,"2016-08-30 21:26:04","2016-08-30 21:26:04"
4852,6000,1375,1375,7375,1,"2016-08-30 21:26:04","2016-08-30 21:26:04"
4853,8000,1474,0,8000,2,"2016-08-30 21:26:04","2016-08-30 21:26:04"
4854,8000,1421,1421,9421,2,"2016-08-30 21:26:04","2016-08-30 21:26:04"
4855,4000,1318,1318,5318,1,"2016-08-30 21:26:04","2016-08-30 21:26:04"
4856,9900,1564,0,9900,2,"2016-08-30 21:26:04","2016-08-30 21:26:04"
4857,9000,1598,1598,10598,2,"2016-08-30 21:26:04","2016-08-30 21:26:04"
4858,4000,1283,1283,5283,1,"2016-08-30 21:26:04","2016-08-30 21:26:04"
4859,8900,1500,1500,10400,1,"2016-08-30 21:26:04","2016-08-30 21:26:04"
4860,8900,1531,0,8900,2,"2016-08-30 21:26:04","2016-08-30 21:26:04"
4861,7000,1494,1494,8494,1,"2016-08-30 21:26:04","2016-08-30 21:26:04"
4862,8500,1505,1505,10005,2,"2016-08-30 21:26:04","2016-08-30 21:26:04"
4863,8000,1410,1410,9410,1,"2016-08-30 21:26:04","2016-08-30 21:26:04"
4864,8000,1409,0,8000,2,"2016-08-30 21:26:04","2016-08-30 21:26:04"
4865,8000,1436,1436,9436,1,"2016-08-30 21:26:04","2016-08-30 21:26:04"
4866,5000,1427,1427,6427,2,"2016-08-30 21:26:04","2016-08-30 21:26:04"
4867,9900,1508,1508,11408,1,"2016-08-30 21:26:04","2016-08-30 21:26:04"
4868,4000,1219,1219,5219,1,"2016-08-30 21:26:04","2016-08-30 21:26:04"
4869,8900,1618,0,8900,2,"2016-08-30 21:26:04","2016-08-30 21:26:04"
4870,5000,1392,1392,6392,1,"2016-08-30 21:26:04","2016-08-30 21:26:04"
4871,5000,1409,1409,6409,1,"2016-08-30 21:26:04","2016-08-30 21:26:04"
4872,8500,1596,0,8500,2,"2016-08-30 21:26:04","2016-08-30 21:26:04"
4873,8900,1574,0,8900,2,"2016-08-30 21:26:04","2016-08-30 21:26:04"
4874,9900,1639,1639,11539,1,"2016-08-30 21:26:04","2016-08-30 21:26:04"
4875,8000,1583,1583,9583,1,"2016-08-30 21:26:04","2016-08-30 21:26:04"
4876,8500,1523,1523,10023,1,"2016-08-30 21:26:04","2016-08-30 21:26:04"
4877,5000,1347,1347,6347,1,"2016-08-30 21:26:04","2016-08-30 21:26:04"
4878,9900,1572,1572,11472,1,"2016-08-30 21:26:04","2016-08-30 21:26:04"
4879,7000,1409,1409,8409,2,"2016-08-30 21:26:04","2016-08-30 21:26:04"
4880,8500,1577,0,8500,2,"2016-08-30 21:26:04","2016-08-30 21:26:04"
4881,8000,1436,0,8000,2,"2016-08-30 21:26:04","2016-08-30 21:26:04"
4882,9500,1643,1643,11143,2,"2016-08-30 21:26:04","2016-08-30 21:26:04"
4883,8000,1546,0,8000,2,"2016-08-30 21:26:04","2016-08-30 21:26:04"
4884,6000,1480,1480,7480,1,"2016-08-30 21:26:04","2016-08-30 21:26:04"
4885,9900,1584,1584,11484,1,"2016-08-30 21:26:04","2016-08-30 21:26:04"
4886,8000,1509,1509,9509,1,"2016-08-30 21:26:04","2016-08-30 21:26:04"
4887,8000,1410,1410,9410,2,"2016-08-30 21:26:04","2016-08-30 21:26:04"
4888,4000,1297,1297,5297,1,"2016-08-30 21:26:04","2016-08-30 21:26:04"
4889,8900,1461,0,8900,2,"2016-08-30 21:26:04","2016-08-30 21:26:04"
4890,8500,1613,0,8500,2,"2016-08-30 21:26:04","2016-08-30 21:26:04"
4891,6000,1483,1483,7483,1,"2016-08-30 21:26:04","2016-08-30 21:26:04"
4892,5000,1332,1332,6332,1,"2016-08-30 21:26:04","2016-08-30 21:26:04"
4893,8900,1509,1509,10409,1,"2016-08-30 21:26:04","2016-08-30 21:26:04"
4894,5000,1262,1262,6262,2,"2016-08-30 21:26:04","2016-08-30 21:26:04"
4895,4000,1315,1315,5315,1,"2016-08-30 21:26:04","2016-08-30 21:26:04"
4896,4000,1213,1213,5213,2,"2016-08-30 21:26:04","2016-08-30 21:26:04"
4897,8900,1592,0,8900,2,"2016-08-30 21:26:04","2016-08-30 21:26:04"
4898,5000,1409,1409,6409,1,"2016-08-30 21:26:04","2016-08-30 21:26:04"
4899,8000,1467,1467,9467,2,"2016-08-30 21:26:04","2016-08-30 21:26:04"
4900,9500,1479,0,9500,2,"2016-08-30 21:26:04","2016-08-30 21:26:04"
4901,8000,1567,1567,9567,2,"2016-08-30 21:26:04","2016-08-30 21:26:04"
4902,8000,1435,0,8000,2,"2016-08-30 21:26:04","2016-08-30 21:26:04"
4903,8900,1552,0,8900,2,"2016-08-30 21:26:04","2016-08-30 21:26:04"
4904,9900,1530,1530,11430,1,"2016-08-30 21:26:04","2016-08-30 21:26:04"
4905,8000,1435,0,8000,2,"2016-08-30 21:26:04","2016-08-30 21:26:04"
4906,8000,1501,0,8000,2,"2016-08-30 21:26:04","2016-08-30 21:26:04"
4907,5000,1416,1416,6416,1,"2016-08-30 21:26:04","2016-08-30 21:26:04"
4908,9900,1594,0,9900,2,"2016-08-30 21:26:04","2016-08-30 21:26:04"
4909,9500,1494,1494,10994,1,"2016-08-30 21:26:04","2016-08-30 21:26:04"
4910,9500,1652,1652,11152,1,"2016-08-30 21:26:04","2016-08-30 21:26:04"
4911,5000,1427,1427,6427,1,"2016-08-30 21:26:04","2016-08-30 21:26:04"
4912,5000,1355,1355,6355,1,"2016-08-30 21:26:04","2016-08-30 21:26:04"
4913,8900,1590,0,8900,2,"2016-08-30 21:26:04","2016-08-30 21:26:04"
4914,5000,1330,1330,6330,1,"2016-08-30 21:26:04","2016-08-30 21:26:04"
4915,9000,1512,1512,10512,1,"2016-08-30 21:26:04","2016-08-30 21:26:04"
4916,8000,1546,1546,9546,2,"2016-08-30 21:26:04","2016-08-30 21:26:04"
4917,8500,1535,0,8500,2,"2016-08-30 21:26:04","2016-08-30 21:26:04"
4918,8000,1412,0,8000,2,"2016-08-30 21:26:04","2016-08-30 21:26:04"
4919,9500,1567,0,9500,2,"2016-08-30 21:26:04","2016-08-30 21:26:04"
4920,4000,1259,1259,5259,1,"2016-08-30 21:26:04","2016-08-30 21:26:04"
4921,9000,1518,0,9000,2,"2016-08-30 21:26:04","2016-08-30 21:26:04"
4922,8000,1515,1515,9515,1,"2016-08-30 21:26:04","2016-08-30 21:26:04"
4923,4000,1282,1282,5282,1,"2016-08-30 21:26:04","2016-08-30 21:26:04"
4924,8000,1530,1530,9530,2,"2016-08-30 21:26:04","2016-08-30 21:26:04"
4925,8900,1552,1552,10452,1,"2016-08-30 21:26:04","2016-08-30 21:26:04"
4926,8000,1434,0,8000,2,"2016-08-30 21:26:04","2016-08-30 21:26:04"
4927,8000,1473,0,8000,2,"2016-08-30 21:26:04","2016-08-30 21:26:04"
4928,4000,1266,1266,5266,1,"2016-08-30 21:26:04","2016-08-30 21:26:04"
4929,8500,1554,0,8500,2,"2016-08-30 21:26:04","2016-08-30 21:26:04"
4930,5000,1329,1329,6329,1,"2016-08-30 21:26:04","2016-08-30 21:26:04"
4931,5000,1390,1390,6390,1,"2016-08-30 21:26:04","2016-08-30 21:26:04"
4932,9900,1587,1587,11487,1,"2016-08-30 21:26:04","2016-08-30 21:26:04"
4933,8500,1620,1620,10120,1,"2016-08-30 21:26:04","2016-08-30 21:26:04"
4934,9500,1489,1489,10989,1,"2016-08-30 21:26:04","2016-08-30 21:26:04"
4935,8000,1419,1419,9419,2,"2016-08-30 21:26:04","2016-08-30 21:26:04"
4936,6000,1416,1416,7416,1,"2016-08-30 21:26:04","2016-08-30 21:26:04"
4937,8000,1503,0,8000,2,"2016-08-30 21:26:04","2016-08-30 21:26:04"
4938,9900,1625,0,9900,2,"2016-08-30 21:26:04","2016-08-30 21:26:04"
4939,8000,1431,1431,9431,1,"2016-08-30 21:26:04","2016-08-30 21:26:04"
4940,7000,1492,1492,8492,2,"2016-08-30 21:26:04","2016-08-30 21:26:04"
4941,5000,1322,1322,6322,1,"2016-08-30 21:26:04","2016-08-30 21:26:04"
4942,8000,1535,1535,9535,2,"2016-08-30 21:26:04","2016-08-30 21:26:04"
4943,9900,1560,1560,11460,1,"2016-08-30 21:26:04","2016-08-30 21:26:04"
4944,9500,1568,1568,11068,1,"2016-08-30 21:26:04","2016-08-30 21:26:04"
4945,8000,1593,1593,9593,1,"2016-08-30 21:26:04","2016-08-30 21:26:04"
4946,9900,1621,1621,11521,1,"2016-08-30 21:26:04","2016-08-30 21:26:04"
4947,5000,1271,1271,6271,2,"2016-08-30 21:26:04","2016-08-30 21:26:04"
4948,4000,1299,1299,5299,1,"2016-08-30 21:26:04","2016-08-30 21:26:04"
4949,8000,1422,0,8000,2,"2016-08-30 21:26:04","2016-08-30 21:26:04"
4950,8900,1588,1588,10488,1,"2016-08-30 21:26:04","2016-08-30 21:26:04"
4951,7000,1511,1511,8511,1,"2016-08-30 21:26:04","2016-08-30 21:26:04"
4952,9500,1617,1617,11117,1,"2016-08-30 21:26:04","2016-08-30 21:26:04"
4953,5000,1372,1372,6372,1,"2016-08-30 21:26:04","2016-08-30 21:26:04"
4954,8500,1498,1498,9998,2,"2016-08-30 21:26:04","2016-08-30 21:26:04"
4955,7000,1465,1465,8465,1,"2016-08-30 21:26:04","2016-08-30 21:26:04"
4956,8900,1505,0,8900,2,"2016-08-30 21:26:04","2016-08-30 21:26:04"
4957,7000,1509,1509,8509,2,"2016-08-30 21:26:04","2016-08-30 21:26:04"
4958,4000,1273,1273,5273,2,"2016-08-30 21:26:04","2016-08-30 21:26:04"
4959,7000,1403,1403,8403,1,"2016-08-30 21:26:04","2016-08-30 21:26:04"
4960,9900,1645,1645,11545,1,"2016-08-30 21:26:04","2016-08-30 21:26:04"
4961,7000,1507,1507,8507,1,"2016-08-30 21:26:04","2016-08-30 21:26:04"
4962,4000,1396,1396,5396,2,"2016-08-30 21:26:04","2016-08-30 21:26:04"
4963,8000,1516,0,8000,2,"2016-08-30 21:26:04","2016-08-30 21:26:04"
4964,8900,1541,0,8900,2,"2016-08-30 21:26:04","2016-08-30 21:26:04"
4965,5000,1434,1434,6434,2,"2016-08-30 21:26:04","2016-08-30 21:26:04"
4966,8900,1492,0,8900,2,"2016-08-30 21:26:04","2016-08-30 21:26:04"
4967,9900,1554,1554,11454,1,"2016-08-30 21:26:04","2016-08-30 21:26:04"
4968,9900,1502,1502,11402,1,"2016-08-30 21:26:04","2016-08-30 21:26:04"
4969,8900,1464,1464,10364,2,"2016-08-30 21:26:04","2016-08-30 21:26:04"
4970,8900,1462,0,8900,2,"2016-08-30 21:26:04","2016-08-30 21:26:04"
4971,8900,1451,0,8900,2,"2016-08-30 21:26:04","2016-08-30 21:26:04"
4972,9900,1677,1677,11577,1,"2016-08-30 21:26:04","2016-08-30 21:26:04"
4973,8500,1489,0,8500,2,"2016-08-30 21:26:04","2016-08-30 21:26:04"
4974,8000,1516,1516,9516,2,"2016-08-30 21:26:04","2016-08-30 21:26:04"
4975,8000,1442,1442,9442,1,"2016-08-30 21:26:04","2016-08-30 21:26:04"
4976,8000,1481,0,8000,2,"2016-08-30 21:26:04","2016-08-30 21:26:04"
4977,8900,1518,1518,10418,1,"2016-08-30 21:26:04","2016-08-30 21:26:04"
4978,9500,1504,1504,11004,1,"2016-08-30 21:26:04","2016-08-30 21:26:04"
4979,8000,1569,1569,9569,1,"2016-08-30 21:26:04","2016-08-30 21:26:04"
4980,5000,1336,1336,6336,1,"2016-08-30 21:26:04","2016-08-30 21:26:04"
4981,4000,1315,1315,5315,1,"2016-08-30 21:26:04","2016-08-30 21:26:04"
4982,9900,1646,1646,11546,1,"2016-08-30 21:26:04","2016-08-30 21:26:04"
4983,8500,1470,1470,9970,1,"2016-08-30 21:26:04","2016-08-30 21:26:04"
4984,9000,1491,1491,10491,1,"2016-08-30 21:26:04","2016-08-30 21:26:04"
4985,8500,1465,1465,9965,1,"2016-08-30 21:26:04","2016-08-30 21:26:04"
4986,9000,1460,1460,10460,2,"2016-08-30 21:26:04","2016-08-30 21:26:04"
4987,4000,1315,1315,5315,1,"2016-08-30 21:26:04","2016-08-30 21:26:04"
4988,5000,1258,1258,6258,2,"2016-08-30 21:26:04","2016-08-30 21:26:04"
4989,8000,1524,0,8000,2,"2016-08-30 21:26:04","2016-08-30 21:26:04"
4990,8500,1520,0,8500,2,"2016-08-30 21:26:04","2016-08-30 21:26:04"
4991,8000,1466,1466,9466,1,"2016-08-30 21:26:04","2016-08-30 21:26:04"
4992,8000,1482,1482,9482,1,"2016-08-30 21:26:04","2016-08-30 21:26:04"
4993,8000,1544,0,8000,2,"2016-08-30 21:26:04","2016-08-30 21:26:04"
4994,8000,1501,0,8000,2,"2016-08-30 21:26:04","2016-08-30 21:26:04"
4995,7000,1474,1474,8474,1,"2016-08-30 21:26:04","2016-08-30 21:26:04"
4996,8900,1597,1597,10497,2,"2016-08-30 21:26:04","2016-08-30 21:26:04"
4997,8500,1561,0,8500,2,"2016-08-30 21:26:04","2016-08-30 21:26:04"
4998,8500,1459,0,8500,2,"2016-08-30 21:26:04","2016-08-30 21:26:04"
4999,6000,1458,1458,7458,2,"2016-08-30 21:26:04","2016-08-30 21:26:04"
5000,8000,1508,0,8000,2,"2016-08-30 21:26:04","2016-08-30 21:26:04"
